минэкономразвития: минэкономразвития
предложить: предложили предложил предложило предложит предложить
дать: данные даст дать данной данная дали дайте
свобода: свободой свободы
разработчик: разработчик разработчикам разработчиком разработчику разработчиками разработчики разработчиков разработчика
воздушный: воздушного воздушным воздушные воздушное воздушных
наземный: наземных
беспилотник: беспилотников
хабра: хабра хабре хабр
всё: всё все }все
сервис: сервиса сервис сервису сервисами сервисом сервисе сервисы сервисах сервисов
министерство: министерство
экономический: экономическое экономического экономические
развитие: развитию развитие развития развитием
подготовить: подготовило подготовили подготовил
законопроект: законопроект законопроекта
который: которым которыми которому которое который которой которую которые которого которых котором которая
подразумевать: подразумевает
возможность: возможностях возможностями возможностей возможности возможность
корректировать: корректировать
отменять: отменять
норма: нормам нормы норм норму
закон: закона закону законы законам закон законов
о: о обо об
безопасность: безопасностью безопасности безопасность
дорожный: дорожного
движение: движению движения движений
защита: защите защиты защита
персональный: персональных персональными
данные: данных данными данным
кодекс: кодекса кодексом кодексы
также: также
обязательный: обязательную обязательна обязательном обязательного
автострахование: автостраховании
гражданский: гражданской
ответственность: ответственность ответственности
участник: участникам участниками участников участники участника
испытание: испытания испытаний испытание
инновационный: инновационного инновационных
транспортный: транспортных транспортного
средство: средства средств средствами
ведомость: ведомости ведомостям
сейчас: сейчас
корректировка: корректировка корректировок
правило: правила правилах правило правилами правил
тестовый: тестовые тестовой тестовый тестовое тестовых
зона: зоне зоны зон зону зонах зона
эксперимент: эксперименты экспериментов эксперимента
возможный: возможной возможным возможные возможного возможна возможных
согласно: согласно
принять: принять принят принятые принятому приняли примут приняты приняло принято примет
прошлый: прошлых прошлой прошлом
год: годы годом годам год году лет гг годов года
экспериментальный: экспериментальной экспериментального экспериментальных
правовой: правовых
режим: режиме режима режимах режим режимов режиму
эпр: эпр
сфера: сферы сфере
инновация: инноваций инновациям
тем: тем
менее: менее
изменение: изменения изменениях изменениям изменений изменение
мочь: можете могут можем могла могли могло мог
противоречить: противоречит противоречить
действовать: действующему действовать действуют действует
законодательство: законодательстве законодательства законодательство законодательству законодательством
поправка: поправок поправки поправками
призвать: призваны призвал
решить: решено решённых решить решил решили решила
проблема: проблеме проблемам проблема проблемой проблемы проблему проблемами проблем проблемах
учитывать: учитывая учитывают
основание: основании основания основанию оснований
временной: временной
приостановка: приостановки
действие: действиям действия действий
нормативный: нормативные нормативных
акт: акты актов
отдельный: отдельным отдельные отдельными отдельных
территория: территорий территориях территории
в: во в
частность: частности
нужно: нужно
ставить: ставить
учёт: учёт учётом
требовать: требовать требуют требующий требует требуемую
нынешний: нынешняя нынешней нынешнее нынешние нынешним
отменить: отменено отменил отменить
пересмотреть: пересмотреть пересмотрено
требование: требований требованиям требование требования
страхование: страхования страховании
владелец: владельца владелец владельцев владельцам владельцем владельце владельцы
транспорт: транспорта транспортом
медосмотр: медосмотра
новый: новых нового новейшими новыми новому новая новые новой новое новый новую новым новом
отчасти: отчасти
развязать: развяжет
рука: руки руке
так: так
позволить: позволили позволило позволит позволят позволить
проводить: проводить проводили
запуск: запуске запуска запуском запусков запуск запуски запуску
вне: вне
прямой: прямыми прямой прямым прямых прямая
радиовидимость: радиовидимости
такой: такое таким такими такая такого такие такую такому таких
например: например
планироваться: планируются планировалось планируется
томский: томской
область: область областях области
рамка: рамки рамок рамках
проект: проектах проекты проект проекте проектам проекту проекта проектом проектов
тайга: тайга
фонд: фонды фонда фонд
перспективный: перспективных перспективные перспективная
исследование: исследование исследования исследовании исследованиями исследований исследованиях исследованию
более: более
проверка: проверкам проверка проверку проверки
технология: технологией технологий технологии технологиях технологиям технологиями технология технологию
постепенно: постепенно
интегрировать: интегрированных интегрирует интегрировать
беспилотный: беспилотных беспилотной беспилотные беспилотными
судный: судна
общий: общая общего общее общий общие общем общей
пространство: пространство пространства пространстве
россия: россию россии россия
говорить: говорить говорят говоря говорит говорил
лидер: лидер лидеров
рабочий: рабочий рабочая рабочей рабочее рабочих
группа: групп группа группам группу группы группах
аэронуть: аэронет
национальный: национальной национальное
технологический: технологического технологических технологические технологический технологической
инициатива: инициативы инициативу инициатива
нти: нти
сергей: сергей
жуков: жуков
подобный: подобная подобные подобных
минтранс: минтранс
готовить: готовил
концепция: концепцию
интеграция: интеграцией интеграции интеграцию
ещё: еще ещё
согласовать: согласована согласует
правительство: правительство правительства правительстве правительством
пресссекретарить: пресссекретарь
ано: ано
платформа: платформу платформах платформе платформы платформа
юрий: юрий
сушиновый: сушинов
отметить: отметила отметить отметил отметили
быть: будут будем будучи будь
работать: работали работающими работал работающих работают работает работавших работать
совместно: совместно
допускать: допускает
полёт: полета полет полёты полетов
определить: определить определит определена
конкретно: конкретно
проходить: проходят проходить проходит
первый: первые первым первой первую первый первое первого первая
программа: программа программы программ программе программу
утвердить: утвердят
ранее: ранее
конец: концу конце конец конца
2021: 2021
работа: работой работа работы работу работе
они: ними они им ими
начаться: началась начнется начались начнётся
2022: 2022
к: к ко
этот: этот этому этой эта эти этих
время: времён времени время временем
должный: должна должно должен должны
разработать: разработать разработало разработала разработает разработан разработал разработана разработаны разработанные
уточнять: уточняя уточняет уточняют
автомобиль: автомобили автомобилей автомобилем автомобиль
считать: считаю считать считает считают считаем
принятие: принятие принятия
благоприятно: благоприятно
отразиться: отразится
рынок: рынком рынке рынка рынках рынку
набрать: набрать набрало
необходимый: необходимы необходимые необходимую необходимых необходим необходимым необходимой
статистика: статистики статистике статистика
представитель: представителя представитель представителей представители
компания: компаний компаниями компанией компанию компания компании
яндекс: яндекс яндексе яндекса
улица: улицах
столичный: столичного
технопарк: технопарка
сколково: сколково
иннополис: иннополиса
татарстан: татарстан
тельавив: тельавива
город: города городах городе городов город
эннарбор: эннарбор
сша: сша
присылать: присылаем присылаемого
хороший: лучшие хорошей хорошая лучшей лучшее хороший хорошие лучшую
статья: статью статьях статьи
месяц: месяца месяце месяцев месяцами месяцы месяц
скоро: скоро
адрес: адрес адреса
прийти: придет пришло прийти
письмо: письма письмо письме
подтвердить: подтвердить подтвердили подтвержденным подтвердил подтвердите
подписка: подписок подписка подписку подписке
сила: силами силе силу
редактор: редактора редактор редакторе
только: только
оставлять: оставлять
комментарий: комментария комментариев комментариях комментарии комментарий
пожалуйста: пожалуйста
шереметьево: шереметьево
домодедово: домодедово
распознавать: распознавать
лицо: лицам лицами лица лиц лицу
пассажир: пассажирам пассажиров пассажира
вместо: вместо
паспорт: паспорта
автоматический: автоматическое автоматическом автоматическая автоматической автоматического автоматический автоматическими
регистрация: регистрация регистрацию регистрации
рейс: рейсов рейс
аэропорт: аэропорты аэропорт аэропортов аэропорту аэропортах
гатвика: гатвик
великобритания: великобритания великобритании
система: систем системы системах система системам системой систему системами системе
распознавание: распознавание распознавания распознаванию
модернизация: модернизации модернизация
предполагать: предполагали предполагает предполагают предполагая
установка: установку установок установки установка
видеокамера: видеокамер
автоматизированный: автоматизированных
турникет: турникетах
egate: egate
именно: именно
таможенный: таможенные таможенного
контроль: контроль контроля
галерея: галерее
вылет: вылета
международный: международных международную международному международной международный
выход: выходов выходом
посадка: посадку посадки
это: это этим
делаться: делается
удобство: удобства
повышение: повышение повышении повышения
прибыль: прибыль прибыли прибылью
ускорение: ускорения
предполётный: предполётных
процедура: процедуру процедур процедурами
становиться: становится становятся
полностью: полностью
участие: участие участия участии
человек: человеку человека людей люди людьми человек людям
предъявление: предъявления
момент: момент момента
самолёт: самолетами самолёт самолёта
чтобы: чтобы
воспользоваться: воспользоваться
гражданин: граждане гражданин граждан гражданам
рф: рф
обязать: обязан
сдать: сдать
единый: единое единую единому единой единого единый
биометрический: биометрических биометрические биометрическую биометрической
ебс: ебс
один: одному одну одни одной одного один одних одном одним одна
отделение: отделений
банк: банком банк банков банка
согласие: согласия согласие
использование: использовании использованием использования использование использованию
биометрия: биометрии
конкретный: конкретное конкретные конкретную конкретных конкретного
цель: цель цели целей целях целью
аналогичный: аналогичный аналогичная аналогичных аналогичные аналогичную
вести: ведёт ведут вести ведет
внедрить: внедренные внедрит внедрили внедрить
готовый: готовых готова готовы готов
сразу: сразу
федеральный: федеральный федеральная федерального федеральной федеральные федеральную
авиационный: авиационные
модернизировать: модернизированы
государственный: государственная государственные государственного государственном государственной государственных
активно: активно
внедряться: внедряются
хитроу: хитроу
караско: караско
уругвай: уругвай
гонконг: гонконге
дубай: дубае
мексика: мексике
другой: другие другого других другая другим другое другому другими
страна: стран странах стране странами страна страны
авиакомпания: авиакомпания
lufthansa: lufthansa
2018: 2018
г: г
осуществить: осуществят осуществила
350: 350
20: 20 20% $20
минута: минут минутах
помощь: помощью помощи
свой: свой своя своих свои своего своё своей своими свое своем своим своём
лосанджелес: лосанджелеса
благодаря: благодаря
идентифицировать: идентифицировать идентифицирующей идентифицировала
далёкий: дальше
считывать: считывать
открывать: открывать
гейт: гейты
посадочный: посадочного посадочная посадочным
талон: талона
если: если
применять: применять применяем применяют применяя
будущее: будущем будущее
помочь: помогла поможет помогут помочь
автоматизировать: автоматизировать
задача: задачи задача
сначала: сначала
затем: затем
таргетинг: таргетинга таргетинг
реклама: рекламе рекламу рекламы реклама
персонализация: персонализации персонализация
услуга: услуги услугами услуг услугу
салон: салоне
далее: далее
трансформироваться: трансформироваться
дружелюбный: дружелюбное
цифровой: цифровым цифровых цифрового цифровое цифровую цифровые цифровой цифровая
комфортно: комфортно
получать: получает получал получать получают
грамотный: грамотный
инструмент: инструмент инструментом инструменты инструментов инструменте инструмента
увеличение: увеличение увеличения увеличением
неавиационный: неавиационных
доход: доходы доход доходов
дмитрий: дмитрий
дырмовский: дырмовский
генеральный: генеральный генеральным
директор: директором директоров директор директора
црт: црт
хакер: хакеры хакерам хакер хакеров
исследователь: исследователю исследователями исследователь исследователя исследователей исследователям исследователи
создать: создана создан созданная создаст созданном созданный создать созданные создали создано создавшая создадут созданными
ия: ии
тренировать: тренирует тренировать
собака: собака собак собаку
команда: команда командам команд команде командой команду$ команды
университет: университетов университет университета
штат: штате штата штат штатов штатах
колорадо: колорадо
nvidia: nvidia
jetson: jetson
edge: edge
тысяча: тысяч тысячах тысячам тысячи тысячу тысяче
изображение: изображении изображение изображения изображений
теперь: теперь
способный: способна способную способные способны
питомец: питомец питомцев
определять: определяя определяет
сидеть: сидит
стоить: стоит стоил
лежать: лежит
занимать: занимать занимает
нужный: нужные нужное нужна нужны нужен
положение: положениях положение положения положением
вознаградить: вознаградит
пёс: пса
автоматически: автоматически
подавать: подавать подавая
угощениеджейсон: угощениеджейсон
сток: стока сток
тот: том тому та те тех той
кэви: кэви
аспирант: аспиранты аспирант
факультет: факультета
информатика: информатики
обучение: обучение обучения
разный: разные разных разного
использовать: использовали использует используемый использовать использовала используемых используемая использовало используемого используемые используя используют использовал используем
камера: камеры камерами камер камерах камеру камера камерой
смочь: смогли сможет смогут смог смогла
проанализировать: проанализировать проанализировали
испытывать: испытываемых испытывал испытывают
доля: доли долей
секунда: секунду секунды
точность: точность
тестирование: тестированием тестированию тестировании тестирования тестирование
составить: составить составят составило составит составила составил
92: 92%
скорость: скорости скорость скоростью
около: около
39: 39
кадр: кадров
секундуисследователь: секундуисследователи
дрессировщик: дрессировщики
дрессировать: дрессировать
удалённый: удаленной удалённо удаленного удалённой удаленный удаленную удаленно удаленная удалённого
хабраредактор: хабраредактор
минцифра: минцифры
отложить: отложить
переход: переход переходе перехода
набор: набору наборы наборах набор набора
номер: номерами номеров [номер] номер номера
восьмёрка: восьмерки
связь: связью связи связь
массовый: массовому массовое массовых массовой массового массовым
коммуникация: коммуникации коммуникаций
опубликовать: опубликовали опубликованных опубликовало опубликуют опубликованном опубликовать опубликованным опубликовал опубликована опубликовав
приказ: приказа приказ
2025: 2025
цифра: цифры цифра
8: 8
абонент: абоненты абонентов абоненту абонента
междугородний: междугородних
вызов: вызовов вызовах
набирать: набирает набирать
0: 0
00: 00
рбк: рбк
нумерация: нумерации
состояться: состоится состоятся состоялся состоялась
2023м: 2023м
впервые: впервые
идея: идею идей идея
возникнуть: возникшие возникла возникнут возникли возникшем
2006: 2006
поэтапный: поэтапным
этап: этапы этап этапа этапе этапов
префикс: префиксов префикс префиксы
междугородный: междугородных
звонок: звонками звонках
на: на $на
второй: второго втором вторая второй вторую
рассчитать: рассчитан
период: периодом периодам период
2028: 2028
предлагать: предлагают предлагает предлагали
перейти: перешел перейдя перешла перейти
закрытый: закрытых закрытый закрыта закрыт
план: планов план планах планам планы плану плане
местный: местных местной местным местные
открытый: открытого открытой открытый открытым открытом открытых
внутригородской: внутригородских
достаточно: достаточно
пять: пяти пять
шесть: шесть шести
семизначный: семизначный
прийтись: придётся пришлось придется
добавлять: добавлять добавляют
соответствовать: соответствовали соответствующей соответствуют соответствует соответствующий
код: кодами код кода коды кодом
закрепить: закрепить
122: 122
служба: служб службе служба службы службой
оперативный: оперативную оперативного оперативной
вопрос: вопросов вопросом вопросам вопросы вопрос вопросу
оказание: оказания оказание
медицинский: медицинских медицинской
врач: врачами
коронавирусный: коронавирусной
инфекция: инфекцией инфекции
ноябрь: ноябре ноября
пандемия: пандемии пандемией
коронавирус: коронавирус коронавируса коронавирусом
решение: решение решении решению решений решения решением
общаться: общаюсь общаться общаются
лишний: лишнего
ожидание: ожидания
ведомство: ведомства ведомстве ведомство
пояснить: пояснено пояснила пояснил пояснили
весь: всей весь всему всеми вся всего всем
слово: слова словам слову
острый: острой
необходимость: необходимости
поэтому: поэтому
перенести: перенести
комфортный: комфортные
срок: срок сроки
глава: глава
минсвязи: минсвязи
леонид: леонид
рейман: рейман
декабрь: декабрь декабря декабре
изменить: изменить изменили
экстренный: экстренных экстренной
начинаться: начинались начинается
нуль: нуля
101: 101
102: 102
103: 103 $103
01: 01
02: 02
03: 03
москва: москве москва москвы
495: 495
предыдущий: предыдущего предыдущая предыдущие предыдущими предыдущих
095: 095
изначально: изначально
2010: 2010
однако: однако
впоследствии: впоследствии
неоднократно: неоднократно
откладываться: откладывалась
украсть: украденных украли украденные
cd: cd
projekt: projekt
red: red
продать: проданы продал продадут
аукцион: аукциона аукционе аукцион
по: по
telegramканал: telegramканал
утечка: утечкой утечек утечку утечке утечки утечка
информация: информации информацию информация информацией
11: 11% $11 11
февраль: февраля февраль февралю феврале
злоумышленник: злоумышленники злоумышленнику злоумышленников злоумышленникам злоумышленник
досрочно: досрочно
прекратить: прекратить прекратили прекращена прекратил прекратит
продаваться: продавались
студия: студии студию студия
включая: включая
исходный: исходный исходных исходным исходные исходному исходными
cyberpunk: cyberpunk
2077: 2077
ведьмак: ведьмака
3: 3% #3 3
продавец: продавцом продавец
получить: получила получено полученной получили получив получит получите получил получить получат получивших полученных полученные
выгодный: выгодное выгодным
предложение: предложения предложение предложениям
торг: торгов торги
площадка: площадки площадок площадке площадкой площадка
exploit: exploit
10: $10 10% 10
посредник: посредниками посредника посредников
стартовый: стартовая
цена: цене цена цен ценам цены
составлять: составляла составлять составляли составляет
1: 1% $1 1
млн: млн
шаг: шагом шаг
500: $500 500
тыс: тыс
выкупить: выкупить
7: 7 $7
предполагаться: предполагалось предполагалась
длиться: длиться
48: 48
час: час часа часов
факт: факт фактов факту
ставка: ставка ставками ставки
покупатель: покупатель покупатели
сделать: сделана сделали сделал сделанным сделав сделано сделанные сделать
лот: лот
снятой: снят
9: 9
выкуп: выкуп
платить: платят платил платить платит
инженер: инженер инженеры
редакция: редакции редакция
дуров: дурова дуров
рассказать: рассказали рассказал расскажут рассказала расскажет расскажем
монетизироваться: монетизироваться
telegram: telegram
павел: павел
канал: каналы каналов канала каналу канал каналах канале
создатель: создатель создатели создателей создателя
мессенжер: мессенжера
старый: старым старому старых старые старый
особенно: особенно
пользователь: пользователю пользователя пользователем пользователях пользователь пользователям пользователями пользователей пользователи
беспокоиться: беспокоиться
собираться: собираются собираться собирается
фактически: фактически
контекстный: контекстной контекстная
основать: основанная основана основали
тематика: тематике
подытожить: подытожил
традиционный: традиционной традиционным традиционные
социальный: социальных социальные социальным социальная
сеть: сеть сетей сетях сети
переслать: перешлют перешли
дозволить: дозволенного дозволенные
эксплуатация: эксплуатации
издатель: издателей
чрезмерный: чрезмерным чрезмерного
сбор: сбора сбор
манипулятивный: манипулятивных
алгоритм: алгоритмов алгоритма алгоритм
он: ему нём он его нему
хотеть: хочет хотело хотите хотел хотят хотели
начало: начале начала начало
январь: января январь январе
появиться: появиться появилось появятся появилась появится появился
крупный: крупных крупнейшая крупнейшую крупный крупнейших
создавать: создают создавал создавая создает создавали создавать
больший: больший большими большему большего большую больших большая большей большим
нагрузка: нагрузок нагрузкам нагрузки нагрузку нагрузкой
сервер: серверам серверах сервера серверы серверов
прошлое: прошлого
монетизация: монетизации
текущий: текущим текущих текущего текущей текущий текущие текущая текущем
остаться: останется останутся
бесплатный: бесплатный бесплатная бесплатные бесплатными бесплатное
дополнительно: дополнительно
число: числе числом числа число
платный: платной платная платные
функциональность: функциональность
бизнескоманда: бизнескоманд
расширить: расширили расширят расширенными расширила расширить
потребность: потребностями потребности потребностей
наса: наса
забронировать: забронировать
место: место месте мест местах места
апрельский: апрельском апрельская апрельской
союз: союзе союза союзах
мкс: мкс
планировать: планируют планировал планируемых планирует планировали планируемом
астронавт: астронавты астронавта астронавтов
следующий: следующим следующих следующего следующая следующей следующие следующем
космический: космических космическом космического космической космическому космическую
станция: станции станцией станций станцию станция
наметить: намечен намечено наметить намечена
апрель: апреле апреля апрель
агентство: агентство агентства агентстве
присутствие: присутствии присутствие присутствия
случай: случаях случаев случае
задержка: задержки задержку задержках
графика: графике графики графика
коммерческий: коммерческие коммерческих коммерческая коммерческую коммерческим коммерческой коммерческом
миссиить: миссиив
сводить: сводит
минимум: минимуму минимум
риск: риск риски рисков риска рисками
связанный: связанным связанных связанной связанные связанную связанными
прерывание: прерывания прерыванием
член: членов член
экипаж: экипажа экипажем экипажей
мксв: мксв
сообщать: сообщаем сообщали сообщают сообщать сообщал сообщает сообщало сообщала
миссия: миссии миссия миссией миссиями миссий
crew2: crew2
запланировать: запланирован запланирована
между: между
boeing: boeing
cst100: cst100
starliner: starliner
совершить: совершит
испытательный: испытательный
​​ич: ​​не
сентябрь: сентябре сентябрь сентября
второе: второе
25: 25% $25 25
март: марта март марте
робин: робин
гейтенс: гейтенс
ио: ио
штабквартира: штабквартира штабквартире
закупать: закупать
кресло: кресла
смешанный: смешанных
американский: американской американские американский американским американских
летать: летать
российский: российскую российское российской российского российским российских российскими российский российская российские российскому российском
космонавт: космонавты космонавта космонавтов
корабль: корабля корабле кораблях
организовывать: организовывали
похожий: похожую похожей похожая
мир: миру мир мире мира
шаттл: шаттла шаттл шаттлами
доставляться: доставлялись
орбита: орбита орбиту орбите орбиты орбитах
экспедиция: экспедиции
орбитальный: орбитального орбитальной орбитальный
стыковка: стыковка
атлантиса: атлантис
произойти: произойдёт произошел произошло произошёл произойдет произошла произошедшем произойти произошедшим
1995: 1995
свернуть: свернули
1998: 1998
годуследующий: годуследующий
олег: олег олегу олега
новицкий: новицкий
пётр: петр
дубров: дубров
корсак: корсаков
освободить: освободить
американец: американца
исключить: исключено исключить
стать: стало стали статей стал стать станет стала станут
исключительно: исключительно
последний: последняя последних последними последний последнее последнем последней последние
десятилетиять: десятилетияв
роскосмос: роскосмосе роскосмоса роскосмос
заявить: заявил заявила заявили
официально: официально
оформить: оформить
отношение: отношению отношения отношение отношении
партнёр: партнёр партнерами партнеров партнера
какой: какие какими каком каких
условие: условиями условиях условием условий условиям условия
соглашенияпервать: соглашенияпервая
spacex: spacex
crew1: crew1
16: 16 16%ную
майкл: майкл
хопкинс: хопкинс
виктор: виктор
гловера: гловер
шеннон: шеннон
уокер: уокер
японец: японец
соич: соичи
ногучить: ногучи
завершиться: завершились завершиться завершится
май: мая мае
причина: причиной причина причине причину причин
взлом: взломом взлома
очистный: очистной очистных очистные
сооружение: сооружения сооружений
пароль: пароли пароля паролями паролей пароль
teamviewer: teamviewer
отсутствие: отсутствие отсутствия отсутствии
брандмауэр: брандмауэра брандмауэров брандмауэр
власть: властей власти
массачусетс: массачусетса массачусетс
предупреждение: предупреждению предупреждение предупреждения
компаниямпоставщик: компаниямпоставщикам
водоснабжение: водоснабжения водоснабжению
инцидент: инцидента инциденте инцидентом инцидент
водоочистный: водоочистной водоочистных
флорида: флориде флорида
5: 5 5% $5
олдсмара: олдсмар
запад: западе
сообщение: сообщения сообщений сообщении сообщение
ссылаться: ссылается ссылаются
уведомление: уведомление уведомления
фбр: фбр
взломесогласный: взломесогласно
многочисленный: многочисленных многочисленные
нарушение: нарушения нарушение нарушении нарушений
сторона: сторону сторона сторон стороне стороны
сотрудник: сотрудник сотрудников сотрудники сотрудникам сотрудниках
руководитель: руководителей руководитель руководителя
предприятие: предприятиям предприятий предприятием предприятие предприятиях предприятия
слабый: слабой слабые слабых
кибербезопасность: кибербезопасности
ars: ars
technica: technica
ссылка: ссылка ссылки ссылку ссылок ссылкой
удаться: удалось удастся
захватить: захватить захватили
короткий: короткое короткий коротких
итог: итогов итогам итоге
привести: привести приведет привели привело привела
непоправимый: непоправимым
последствие: последствия последствиям
утверждаться: утверждалось утверждается
доступ: доступа доступе доступ доступов доступу
программный: программного программных программный программное программной программном программному
обеспечение: обеспечению обеспечением обеспечении обеспечения обеспечение
scada: scada
управлять: управляют управлять управляющий управляет
вход: входа входе
кроме: кроме
компьютер: компьютерах компьютере компьютеры компьютеров компьютером
устаревший: устаревший устаревшей устаревшую устаревшим
32разрядный: 32разрядной
windows: windows
помимо: помимо
прочее: прочего
отсутствовать: отсутствовал отсутствуют
скриншот: скриншотами скриншот
оказывать: оказывать оказывающих
водоснабжениювластить: водоснабжениювласти
список: списком списка списку список списке
рекомендация: рекомендации рекомендаций
поставщик: поставщиков поставщикам поставщика поставщиком
вода: воде вода воды воду
посоветовать: посоветовали посоветовал
ограничить: ограничена ограничен ограничить
подключение: подключения подключении подключением подключение
осуществляться: осуществляется осуществляться
физический: физическими физического
процесс: процесса процесс процессов процессы процессах процессами процессе
рекомендовать: рекомендовать рекомендует рекомендуем рекомендуют
актуальный: актуальные актуальна
версия: версий версия версиях версию версиями версией версии
ввести: ввести введен введет
двухфакторный: двухфакторную
аутентификация: аутентификацию аутентификации
надёжный: надёжными надёжный надежная
безопасный: безопасные безопаснее безопасным безопасной безопасных
олдсмаре: олдсмаре
городской: городского
офис: офиса офис
ответить: ответила ответят ответит ответили
просьба: просьба просьбу
прокомментировать: прокомментировать
публикация: публикации публикация публикаций публикацию
неустановленный: неустановленные
несколько: нескольким несколько нескольких несколькими
увеличить: увеличена увеличить увеличила увеличили
концентрация: концентрация концентрациях концентрации концентрацию
щёлочь: щёлочи щёлочь
111: 111
оператор: операторами оператор операторов оператору операторы операторам оператора
своевременно: своевременно
заметить: заметил заметить заметили
вернуть: вернул вернули вернуть
значение: значение значения
параметр: параметр параметров параметра параметры
результат: результате результаты результатам
количество: количество количества количеству количествах
попасть: попавшего попала попавшие попал попасть
гидроксид: гидроксид гидроксида
натрий: натрия
оказаться: оказалась оказалось оказались оказался
минимальный: минимальным минимальные
потребитель: потребителям потребителей
угрожать: угрожало угрожает
утверждать: утверждал утверждают утверждали утверждает
шериф: шериф шерифа
округ: округа округов округе
пинелласа: пинеллас
боб: боб
гуалтьери: гуалтьери
обеспокоиться: обеспокоились
поскольку: поскольку
существенный: существенное существенными существенную существенных существенные
высокий: высокие высоким высокое высокой высоких высокая высока высоком
вызывать: вызывать вызывает вызывают
раздражение: раздражения
кожа: кожи
глаз: глаз
химический: химические
ожог: ожоги
тяжёлый: тяжёлых
амасессия: амасессию амасессия
service: service
mesh: mesh
17: 17
блог: блога блоге блогах блог
southbridge: southbridge
29531: 29531
рейтинг: рейтинг рейтинге
обеспечивать: обеспечивать обеспечиваем обеспечивает обеспечивающая
стабильный: стабильной стабильную
highloadпроект: highloadпроектов
слёрма: слёрм слёрма
провести: провели провела проведет провести проведёт провел
оставить: оставить оставили оставят
заранее: заранее
эксперт: экспертами эксперты эксперта экспертом экспертов
отвечать: отвечать отвечают отвечающей отвечала
самый: самая самый самые самых самым самое самую
популярный: популярного популярна популярный популярные популярных популярным
мероприятие: мероприятие мероприятия мероприятию мероприятиях
понять: поняли понял понять пойму
насколько: насколько
ваш: вашей вашему вашу ваши вашего ваших
возможно: возможно
частично: частично
выбрать: выбрали выберут выбрать выбрана выбран
конфигурация: конфигурации конфигураций
писать: писать пишет пишите пишут писали пишете
serviсe: serviсe
столкнуться: столкнулись столкнутся столкнуться
интересно: интересно
начать: начать начнут начал начали
смотреть: смотрите смотрели смотреть
qaсессия: qaсессия
давать: давала даёт дают давали давать дает
ответ: ответах ответы ответ ответов ответа
наш: наша наше нашем наш нашим наших нашего нашей наши
пройти: пройдет пройдёт прошли прошёл
видеоформат: видеоформате
ведущий: ведущие ведущий ведущих ведущим
озвучивать: озвучивать
чат: чат чата чатам чате чатов
форма: форма форме форму формой формы
отличие: отличий отличие
митапа: митапа
круглый: круглого круглый
стол: стол стола
дискуссия: дискуссию
ценность: ценность
заключаться: заключалась заключается заключающуюся
донесение: донесении
опыт: опыт опыта опытом опыте
кратко: кратко
понятно: понятно
раскрыть: раскроет раскрыть
тема: тему темой тема
дата: дата дату даты
проведение: проведением проведения проведение проведении
19002000: 19002000
utc: utc
+3: +3
стоимость: стоимость стоимости стоимостью
бесплатно: бесплатно
студент: студентами
выпускник: выпускник выпускников выпускниками
онлайнинтенсив: онлайнинтенсивы
2728: 2728
35: 35
1921: 1921
apple: apple
заменить: заменит заменить
аккумулятор: аккумуляторы аккумулятора аккумуляторов
macbook: macbook
pro: pro
2016/2017: 2016/2017
замена: замены
модель: модель модели моделей
2016: 2016
2017: 2017
выпуск: выпуске выпуска выпуск выпуском выпусков
учаcтие: учаcтие
батарейapple: батарейapple
выпустить: выпустит выпущенных выпустила выпустил выпустили выпустить выпущено выпущенные выпущен
обновление: обновление обновлению обновлений обновления обновлением обновлении
macos: macos
1121: 1121
catalina: catalina
10157: 10157
исправить: исправили исправить исправлена
ошибка: ошибках ошибками ошибкой ошибку ошибкам ошибок ошибки ошибке ошибка
батарея: батареи батарее
заряжаться: заряжаться
патч: патчем патчи патче патч
обратиться: обратилась обратиться
отнести: отнести
ноутбук: ноутбуков ноутбук ноутбуках ноутбуки ноутбука
сервисный: сервисный
центр: центров центром центр центра центрам
заявлять: заявляет заявляют заявляли заявлял
очень: очень
небольшой: небольших небольшим небольшие небольшое
клиент: клиенты клиентов клиента клиентами клиентам
сталкиваться: сталкивается
узнать: узнать
состояние: состоянии состояние
устройство: устройства устройствах устройстве устройствами устройство устройству устройств устройствам
нажать: нажав
значок: значок
системный: системного системные системному
настройка: настройках настройке настройки настроек
у: у
затронуть: затронуло затронутых затронет затронуть
показывать: показывают показывать показывает
рекомендоваться: рекомендуется
обслуживание: обслуживания обслуживание
ниже: ниже
перечислить: перечислены
запускать: запускать запускает запускали запускала
13дюймовый: 13дюймовых
октябрь: октябре октябрь октября
некоторый: некоторых некоторого некоторым некоторые
вздуваться: вздувались
запустить: запустив запустили запущена запустил запустило запустит запустить запустила запущен
клавиатура: клавиатуры
страдать: страдают
залипаний: залипания
невосприимчивость: невосприимчивости
клавишоб: клавишоб
история: историй истории историями историю история
удачный: удачных
прочитать: прочитать
вирусный: вирусным вирусный
фильтр: фильтров фильтром фильтр
я: я меня
кот: кот кота
видео: видео
техасский: техасский
адвокат: адвокат
появляться: появляется появляться появляются
кошачий: кошачий кошачьим кошачьей
онлайнзаседание: онлайнзаседании
суд: суда суде суд
zoom: zoom
оправдываться: оправдывается
заинтересоваться: заинтересовались
ктоть: ктото
предположить: предположил
юрист: юристов юрист
дипфейктехнология: дипфейктехнологию
но: но
дело: деле дела дело
гораздо: гораздо
простой: проще простое простоев простой
выясниться: выяснилось
включить: включить включив включённой включен включил
предустановленный: предустановленное
dell: dell
причём: причем
софт: софт софта софту
live: live
cam: cam
avatar: avatar
доступно: доступно
загрузка: загрузку загрузок загрузки загрузка загрузке
делиться: делитесь делиться
ник: ником
chembark: chembark
грустный: грустным
котёнок: котенком
собеседование: собеседовании собеседований
skype: skype
отчаянно: отчаянно
скроллить: скроллить
меню: меню
пытаться: пытается пытаться пытались пытаясь
ситуация: ситуация ситуацию ситуации
жаловаться: жаловаться жаловались жалуются жалуется
настроить: настроена настроить настроено
умолчание: умолчанию
вебкамера: вебкамере вебкамеры вебкамер
пост: пост постов поста
подробный: подробнее подробного подробные
инструкция: инструкцией инструкции
удаление: удаления удаление удалением удалению удалении
глупый: глупого
белый: белым белого белый
reallusion: reallusion
описать: описала описана описали
настраивать: настраиваемую
анимация: анимации анимацией анимацию
эмоция: эмоциями
доставить: доставит
удовольствие: удовольствия
обычный: обычный обычной обычные обычных
видеочат: видеочат
настоящий: настоящий настоящих настоящее настоящей
разрабатывать: разрабатывать разрабатывает разрабатываемая разрабатывала разрабатываемых
сложный: сложнейшего сложное сложной сложны сложных сложную
3dанимация: 3dанимации
реальный: реальными реальных реального реальные реальном реальным реальной
пока: пока
правда: правда
вскрыться: вскрылась
наслать: нашли
альтернативный: альтернативные альтернативный
способ: способом способов способы способ
создание: создания создании созданию созданием создание
приложение: приложению приложении приложений приложение приложения приложением
snapchat: snapchat
snap: snap
camera: camera
facebook: facebook
трансляция: трансляции трансляция
прессконференция: прессконференции
пакистанский: пакистанского
политика: политике политика политики
превратиться: превратиться превратилась
фарс: фарс
выставить: выставил выставят выставили
язык: языком языке язык языка
go: go
наконецтый: наконецто
дженерик: дженерики дженериков
proposal: proposal
как: как
телеграмканал: телеграмканале телеграмканал телеграмканалов
добавление: добавлением добавлению
документ: документами документ документам документы документе документах документа
type: type
stringer: stringer
interface: interface
string: string []string
plusser: plusser plusser]s
plusstring: plusstring
func: func
concatto: concatto[s
p: []p p p[i]plusvstring
s: s []s
r: r[i] r
make: make[]string
lens: lens
for: for
i: i
v: v
range: range
return: return
означать: означает
скорее: скорее
118beta: 118beta
попробовать: попробовать
цитата: цитата
официальный: официальном официальных официального официальный
if: if
the: the
is: is
accepted: accepted
our: our
goal: goal
will: will
be: be
to: to
have: have
a: a
complete: complete
though: though
perhaps: perhaps
not: not
fully: fully
optimized: optimized
implementation: implementation
people: people
try: try
by: by
end: end
of: of
year: year
as: as
part: part
118: 118
betasт: betasте
постараться: постараются постарались постарается
какойтый: какойто
вариант: варианты вариант
слишком: слишком
оптимизировать: оптимизировать оптимизированный
поиграться: поиграться
поздравлять: поздравляем
гофер: гоферов
отличный: отличный отличной отличных
новость: новостями новостью новостях новостей новости
тимлида: тимлид
подкаст: подкаста подкаст подкастов
цинковый: цинковый
прод: прод
раздать: раздаст
fitbit: fitbit
отследить: отследить отследили
распространение: распространением распространения распространение распространении
выдать: выдаст выдало
150: 150 $150
пилотный: пилотную пилотной
сдерживание: сдерживанию
коронавирусас: коронавирусас
умный: умное умных умные
браслет: браслетов
ежедневно: ежедневно
отслеживать: отслеживать отслеживают отслеживает
ключевой: ключевых ключевого ключевым ключевые
показатель: показатель показатели показателей
здоровье: здоровья здоровью
частота: частоты частоту частот частотах частоте частотой
пульс: пульса
дыхание: дыхания
покой: покоя
носить: носимые носит носимых носили
выявить: выявить выявили
гриппоподобный: гриппоподобное
заболевание: заболевание
covid19: covid19
появление: появления появлению появлении
симптом: симптомов
важно: важно
передать: передала передать
вирус: вирус
протекать: протекает
бессимптомный: бессимптомно
функция: функции функций функцию функцией функциях функция
ready: ready
work: work
daily: daily
checkin: checkin
позволять: позволяющими позволяющая позволявший позволяла позволяя позволяющий позволяет позволял позволяющей
регистрировать: регистрируют регистрировать
основа: основе основу
предоставить: предоставят предоставит предоставленные предоставили предоставить предоставлено предоставленное предоставила
сам: само сама самой самом сами самих сам самого
температура: температурах температуры температуре
тело: тела
идти: идет идти идут
оставаться: остается оставаться оставалось
доманас: доманаса
оценить: оценит оценили оценить
рассмотреть: рассмотреть рассмотрим рассмотрит рассмотрено
расширение: расширение расширению расширения расширении расширением расширений
широкий: широкий широк
круг: кругах круг кругов
годовой: годовой
premiumtmнас: premiumtmнаса
принимать: принимает принимавший принимать
мера: мер мере меры
предотвращение: предотвращению предотвращения
объект: объект объектов объектах
перевести: переведет переведённый перевело
везде: везде
предназначить: предназначенной предназначен предназначена
дополнение: дополнение дополнений дополнения
стэнфордский: стэнфордский
польза: пользы
обнаружение: обнаружения обнаружение обнаружении
различный: различными различных различным различные
garmin: garmin
производитель: производители производителем производителям производителя производителей производителями
показать: показала покажем покажет показал показало
81: 81%
заболеть: заболевших
гаджет: гаджеты
фиксировать: фиксировали фиксирована
девять: девять
день: день дни дня днем дней дне днях
android: android
jetpack: jetpack
activity: activity
result: result
api: api
рефакторинг: рефакторинг рефакторинга
fragment: fragment
привет: привет
с: с
вы: вам вами вы вас
broadcast: broadcast
2: 2
неделя: неделю недели неделе недель
очередной: очередной
релиз: релизах релиз релизы релизами релизе релиза
библиотека: библиотек библиотеках библиотека библиотеки библиотеке
google: google
мы: нам нами мы
выйти: выйти вышло вышла выйдет вышел вышедшей
долгожданный: долгожданное
исправление: исправлений исправление исправления
множество: множеству множества
баг: багов баг
изз: изза
внутри: внутри
fragmentmanager: fragmentmanager
интересный: интереснее интересные интересное интересных
найти: найдете найти нашёл найдено
подробность: подробности
узнавать: узнавать узнают
разработка: разработкой разработки разработка разработку разработок разработке
подписаться: подпишитесь подписаться
следить: следил следит следите следить
формат: форматов формата формат формате форматы
val: val
getcontent: getcontent
registerforactivityresultgetcontent: registerforactivityresultgetcontent
uri: uri
//: }// //
handle: handle
returned: returned
override: override
fun: fun
oncreatesavedinstancestate: oncreatesavedinstancestate
bundle: bundle
selectbutton: selectbutton
findviewbyid: findviewbyid<button>ridselect_button
selectbuttonsetonclicklistener: selectbuttonsetonclicklistener
pass: pass
in: in
mime: mime
youd: youd
like: like
allow: allow
user: user
select: select
input: input
getcontentlaunch: getcontentlaunch"image/*"
fragment1: fragment1
superoncreatesavedinstancestate: superoncreatesavedinstancestate
use: use
kotlin: kotlin
extension: extension
fragmentktx: fragmentktx
artifact: artifact
setfragmentresultlistener: setfragmentresultlistener"requestkey"
requestkey: requestkey
we: we
here: here
but: but
any: any
that: that
can: can
put: put
supported: supported
bundlegetstring: bundlegetstring"bundlekey"
do: do
something: something
with: with
buttonsetonclicklistener: buttonsetonclicklistener
``: "ключзначение" "result" "файл">"учётная "" "zoneidentifier"
setfragmentresult: setfragmentresult"requestkey"
bundleof: bundleof"bundlekey"
искать: ищите ищет ищем искать
признак: признака признаки признакам признаков
жизнь: жизни
загрязнить: загрязненных
планета: планет планетах планете планеты планету
поиск: поиска поиск
внеземной: внеземных внеземную
цивилизация: цивилизации цивилизаций цивилизацию
потенциально: потенциально
присутствовать: присутствовать присутствующих присутствовали
наблюдаться: наблюдается
атмосферный: атмосферное
загрязнение: загрязнение
газообразный: газообразный газообразного
диоксид: диоксид диоксида
азот: азота
no2: no2
земля: земле земли
образоваться: образуется
сжигание: сжигании сжиганием
ископаемое: ископаемого
топливо: топлива
активность: активности
вулкан: вулканов
равить: рави
коппарап: коппарапу
имя: именами именем имени имена именах имен
годдард: годдарда
гринбелт: гринбелте
отмечать: отмечаем отмечает отмечал отмечают
нижний: нижней нижние нижних
слой: слоя слои слоях слой
атмосфера: атмосферой атмосфере атмосферу атмосферы
высота: высоте высота высотой
15: $15 15% 15
км: км
промышленный: промышленное промышленной промышленные промышленного промышленную промышленных промышленный промышленным
происхождение: происхождения происхождение
преобладать: преобладает преобладающей
следовательно: следовательно
указывать: указывает указывают указывать
индустриальный: индустриальной
сегодняшний: сегодняшние сегодняшний
астроном: астрономы
обнаружить: обнаружили обнаружить обнаружена обнаруженных обнаружил
4000: 4000
вращаться: вращающихся вращающиеся
вокруг: вокруг
звезда: звезды звезд
подходящий: подходящие
экзопланета: экзопланеты
удалить: удалила удалено удалить удалена удалены удалит удалил удалили
учёный: ученым ученые учёные ученых учёным
мощный: мощным мощный мощная мощнее мощной мощные
телескоп: телескопы телескопов
изучать: изучают изучать
качество: качеству качества качество качестве
рассматриваться: рассматривалось рассматриваются
кислород: кислорода
метан: метана метане
выявлять: выявлять
изучаться: изучались
хлорфторуглерод: хлорфторуглероды
техносигнатура: техносигнатур
широко: широко
использоваться: используется использовался используются использоваться использовались
пора: пор поры
истощать: истощает
озоновый: озоновый озонового
хфу: хфу
являться: являются являющиеся являлись является
парниковый: парниковых парниковым
газ: газом газа газ газов
производиться: производится производиться производятся
биологический: биологическими
источник: источниками источника источник источники источником
специфический: специфические
вещество: вещества веществ
встречаться: встречаться
побочный: побочным
продукт: продуктов продукты продукт продуктами продукту продуктом продуктах продукта
любой: любом любого любому любой любое любым любых любые
сгорание: сгорания
компьютерный: компьютерной компьютерных компьютерное
моделирование: моделирование моделирования
предсказать: предсказать
обнаруживаться: обнаруживаться
существующий: существующих существующую существующего существующей
поглощать: поглощает поглощают
длина: длинах длины длиной
волна: волн волны
видимый: видимого видимая
свет: света свет
подтверждать: подтверждают подтверждать подтверждает
расстояние: расстоянии расстояние
30: $30 30% 30
световой: световых световые
примерно: примерно
400: $400 400
часами: часами
наблюдение: наблюдений наблюдения наблюдениям
холодное: холодные
солнце: солнце солнцу
производить: производить производит
сильный: сильный сильные сильнее
легко: легко
обнаруживать: обнаруживать обнаруживаемый обнаруживают
сигнал: сигнал сигналов сигнала
излучать: излучают
маленький: маленькая маленького мала меньше
ультрафиолет: ультрафиолета
сложность: сложность сложности
состоять: состоит
иметь: имеющий имел имеют имеет иметь имеющие имеющих
76: 76% 76%помимо
выброс: выбросов
приходиться: приходилось приходится
деятельность: деятельность деятельности
соотношение: соотношение
естественный: естественного естественным
потребоваться: потребуется потребовались
при: при
вероятность: вероятность
ложный: ложного ложных
срабатывание: срабатывания
помешать: помешать
облако: облака облаке облаков
аэрозольный: аэрозольные
газа: газы
имитировать: имитируют имитировать
сигнатура: сигнатуру
для: для
отличить: отличить
продвинуть: продвинутые
3dмоделить: 3dмоделив
руководство: руководства руководством
массачусетский: массачусетского массачусетский
институт: институт института
многопланетный: многопланетную
четыре: четырьмя четыре четырёх
200: 200 $200 >200
наблюдать: наблюдать наблюдали
эволюционировать: эволюционируют
фас: фас
возбудить: возбудила возбудили возбудило
против: против
tele2: tele2
тариф: тарифы тарифам тарифов тарифах
антимонопольный: антимонопольных антимонопольная
13: 13 13%
прессрелиз: прессрелизе
сайт: сайта сайт сайты сайтах сайте сайтов
12: 12% 12
миллион: миллионы миллионах миллионов миллиону миллион миллиона
поступить: поступившим поступившего поступила поступило
большой: большое большой большого велика
жалоба: жалобу жалобы жалоб
говориться: говорится
повысить: повысил повысила повысили повысить
п1: п1
ч1: ч1
ст10: ст10
конкуренция: конкуренцию конкуренции
установление: установление
поддержание: поддержание
монопольно: монопольно
низкий: низким низкие низких низкой низкими
товар: товара товаров
ущемлять: ущемляет
интерес: интересам интересы
иной: иной иные
обоснование: обоснования обоснование
интерфакс: интерфаксу
действительно: действительно
повыситься: повысилась
коснуться: коснулось
ряд: ряду ряда ряд
архивный: архивных
меняться: меняются менялась меняется менялись
прежде: прежде
среднее: среднего среднем
пересмотр: пересмотр
рубль: рублей рубля
заверить: заверили
обусловить: обусловлено
инвестиция: инвестиций инвестиции
фон: фоне
рост: ростом росту рост роста
пользовательский: пользовательский пользовательские пользовательского
трафик: трафик трафика
предупредить: предупредила предупредить предупредил
июль: июля июле июль
2020: 2020
регулятор: регуляторов регулятор регулятора
два: два двумя две двух
признать: признали признала
незаконно: незаконно
недостаточный: недостаточным
согласиться: согласились согласился согласится согласиться
вывод: вывода выводах вывод выводы выводами выводу
уверять: уверяет уверяют уверяли
затрагивать: затрагивало
оспаривать: оспаривает оспаривая
мвд: мвд
госзакупка: госзакупках госзакупку госзакупок
изучение: изучения изучение
борьба: борьбы борьбе
дипфейк: дипфейками дипфейков
фото: фото
вестиhitech: вестиhitech
портал: портал портале портала
тендер: тендеру тендеров тендер
выявление: выявления
внутрикадровый: внутрикадрового
монтаж: монтажа
видеоизображение: видеоизображений
выполнить: выполнена выполните выполнить выполнив выполнил выполнили выполненного
нейронный: нейронных
шифр: шифр
зеркало: зеркало
верблюд: верблюд
научный: научного научных научном научными научный научной
изыскание: изысканий
исполнитель: исполнитель
технический: технических технический техническими технические техническим техническое технического техническую
задание: заданием задание
программноаппаратный: программноаппаратного
комплекс: комплекс комплекса комплексу
инициатор: инициатором
выступить: выступило выступил выступили
фку: фку
научнопроизводственный: научнопроизводственное
объединение: объединение
специальный: специальная специальный специальную
техника: техникой технике технику техника
первоначальный: первоначальные первоначальная первоначальный первоначальных
исследовательский: исследовательской исследовательские исследовательских исследовательского исследовательским
материал: материалам материала материал материалов материалы
ход: ходу ход ходе
уровень: уровень уровнем уровне уровня
научнотехнический: научнотехнического
экспертнокриминалистический: экспертнокриминалистических
подразделение: подразделение подразделений
линия: линии линий
производство: производство производства производству
видеотехнический: видеотехнических
экспертиза: экспертиз
конкурс: конкурса конкурс конкурсов
комплексный: комплексный комплексная
анализ: анализ анализу анализе анализа анализов
делать: делали делаем делают делает делать
предусматривать: предусматривает предусматривают
систематизация: систематизацию
доступный: доступных доступными доступен доступна доступны
зарубежный: зарубежном зарубежные зарубежным зарубежных
видеозапись: видеозаписей видеозаписи
нейросеть: нейросети нейросеть нейросетей
изучить: изучить
содержаться: содержащимся содержащихся содержались содержится
видеофайл: видеофайлах
распространить: распространенная распространенных
представить: представила представлены представленных представит представленная представили
обстоятельство: обстоятельствах
получение: получение получения
интернет: интернета интернет интернете
контракт: контракт
теоретический: теоретической теоретическое теоретического
патентный: патентных
63: 63
модуль: модуль модулем модули модуля модулей
антимошенник: антимошенник
мобильный: мобильных мобильное мобильном мобильной мобильные мобильным мобильный мобильного
ios: ios
встроить: встроить встроена встроенную встроят встроенной встроены встроили встроенные
полиция: полицией полиции полиция
мошеннический: мошеннических мошенническими
смсрассылка: смсрассылками
осень: осенью
microsoft: microsoft
фотография: фотографий фотография фотографиях
она: неё она ей
дезинформация: дезинформацией дезинформации
контент: контент контента контенту контентом
кандидат: кандидат кандидатами кандидатов
президентский: президентских президентская
выборы: выборов
подделка: подделок
минцфира: минцфиры
допустить: допустить допустим
реестр: реестр реестра
отечественный: отечественного отечественном отечественных
условно: условно
переработать: переработанные
переработка: переработку переработка
постановление: постановление постановлению
импортозамещение: импортозамещении
доказательство: доказательству доказательство доказательствами доказательства доказательств
оригинальность: оригинальности
обсуждаться: обсуждалась обсуждалось
экспертный: экспертном экспертный
совет: совета советами совете советы совет
внести: внесены внесли внести
100: 100 100% $100
дополненийоднако: дополненийоднако
финальный: финальной
образ: образом
включение: включения включении включение
претендовать: претендовать претендует
элемент: элементов элементы элементами
копия: копию копии копия
иностранный: иностранными иностранных
свободный: свободный свободное свободным свободных
участвовать: участвовать участвовали участвующие
есть: есть
бонус: бонусы
предусмотреть: предусмотрена предусмотрен предусмотреть
льготный: льготная
налог: налогу
понизить: пониженные пониженного
страховой: страхового страховые
взнос: взносы
исчезнуть: исчезло исчезнет
упоминание: упоминание упоминания
квота: квоте
ассоциация: ассоциаций
спо: спо
распространяться: распространяются распространяется
лицензия: лицензиям лицензию лицензией лицензии лицензий
существенно: существенно
доработать: доработать
исключительный: исключительные
право: правами право права
производный: производный
входить: входят входил
базальт: базальт
astra: astra
linux: linux
мой: мой
р7: р7
alteroffice: alteroffice
2019: 2019
единственный: единственный единственным
случаем: случаем
исключение: исключением исключения
компанияразработчик: компанияразработчик
взять: взяла взять взяли
основательный: основательную
часть: часть частей частью части
автор: авторы авторам авторов автор
libreoffice: libreoffice
обладать: обладает обладающими
сообщество: сообществами сообществ сообщество сообщества
document: document
foundation: foundation
доработка: доработку доработки
уникальность: уникальность
36: 36 36%
фиктивный: фиктивные
вносить: вносят
полноценный: полноценную полноценными полноценная полноценным полноценного
роль: роль
номинальный: номинальная номинальной номинальна
юридический: юридических юридической
фирма: фирмы
антон: антон антона
серго: серго
обеспечить: обеспечить обеспечит
поддержка: поддержку поддержкой поддержка поддержке поддержки
собственный: собственные собственную собственного собственным собственный
перепродавать: перепродавать
наносить: наносить
вред: вред вреда
нести: несут несет
расход: расходов расходы
попрежний: попрежнему
полный: полон полного полную полное полный полны
распространять: распространяемыми распространять
условный: условным
лишь: лишь
перевод: переводе перевод
русский: русский
сетовать: сетует
ввезти: ввезли
партия: партию
оборудование: оборудование оборудования оборудовании оборудованием
майнинга: майнинга майнингу майнинге
4060: $4060
разовый: разовую
майнинговый: майнингового
мощность: мощность мощности
70: $70 70 70%
мвт: мвт
розничный: розничного
основатель: основателями основатель основателя
датацентр: датацентров датацентра
bitriver: bitriver
игорь: игорь
рунец: рунец
поставить: поставлено
после: после
поставка: поставок поставки
иркутский: иркутском
братск: братске
запуститься: запустился запустилась
обособленный: обособленный обособленного
цод: цод
tieriii: tieriii
bloomberg: bloomberg
находиться: находиться находится находились находятся
майнингферма: майнингферма
принадлежать: принадлежит принадлежат
миллиардер: миллиардеру
дерипаск: дерипаске
ферма: фермы
целое: целом целого
япония: японии
китай: китай китае китая
закупить: закупили закупить
азия: азии
название: названием название
раскрываться: раскрывается
chilkoot: chilkoot
артём: артем
ерёмин: еремин
обычно: обычно
специализировать: специализированное
asicчип: asicчипах
бренд: бренды брендом брендов бренд
bitmain: bitmain
whatsminer: whatsminer
innosilicon: innosilicon
avalon: avalon
sixnines: sixnines
трошин: трошин
уверенный: уверен
закупаться: закупались
современный: современных современные современной
btc: btc
asic: asic
подсчитать: подсчитал
майнить: майнить
мировой: мировой мировом
биткойнсеть: биткойнсети
оценка: оценкам оценка оценку оценке
третий: третье третий третья третьим третьего третьей третьими
расти: растущей растут растущем
капитализация: капитализации капитализация
биткоина: биткоины биткоина биткоин
майнер: майнеры майнерам
завозить: завозить
отрасль: отрасли отрасль
определённый: определенным определенные определенных
уверить: уверены
негласный: негласное
разрешение: разрешением разрешение разрешения
финансовый: финансовым финансовый финансовые финансовой финансовое финансовых финансовыми
актив: активам активах активов активы
заработать: заработать заработал заработают
туманный: туманным
вводить: вводящий вводит вводят
понятие: понятие
криптовалюта: криптовалюты криптовалюту криптовалюте криптовалютам
запрещать: запрещающим запрещают запрещающий запрещает
её: её
оплата: оплату оплаты оплате оплата
законодатель: законодатели
пообещать: пообещали пообещала
минфин: минфин
уголовный: уголовный
уголовнопроцессуальный: уголовнопроцессуальный
валюта: валюту валюте валюты валюта валют
декларировать: декларирующих
иходнако: иходнако
бизнес: бизнес бизнеса
легализовать: легализован
течение: течение
оценивать: оценивать оценивают оценивает
задействовать: задействованы задействованных задействует
человекраный: человекранее
резкий: резкого
сильно: сильно
вырасти: выросли выросла
продажа: продажи продажу продаже продаж
видеокарта: видеокартами видеокарты видеокарт
окупаемость: окупаемости
упасть: упали упал
одновременно: одновременно
дефицит: дефицит дефиците дефицита
топовый: топовые
пропасть: пропали пропало
спектрометр: спектрометром спектрометр спектрометра
марс: марсе марс марса
хлороводород: хлороводород хлороводорода
atmospheric: atmospheric
chemistry: chemistry
suite: suite
химия: химии
acs: acs
измерение: измерениями
известно: известно
солнечный: солнечной
венера: венере
составной: составных составной
tras: tras
gas: gas
orbiter: orbiter
совместный: совместный совместное совместного совместную совместной
российскоевропейский: российскоевропейского
exomars2016: exomars2016
исследовать: исследует исследовал исследуют
распределение: распределению распределение
вместе: вместе
аппарат: аппарат аппаратом аппарате
бельгийский: бельгийской бельгийский
nomad: nomad
анализировать: анализируя анализировать анализирует
компонент: компоненты компонент компонентов
марсианский: марсианском марсианского марсианской марсианскую марсианских
hcl: hcl
попадать: попадает попадало
море: моря
частица: частицами частицы
морской: морских морские
соль: солей
превращаться: превращаются
аэрозоль: аэрозоль
реагировать: реагирует
озон: озоном
гидроксильный: гидроксильными
радикал: радикалами
зависеть: зависит зависят
окислительный: окислительные
свойство: свойств свойства
сезонный: сезонного
утончение: утончения
полюс: полюсами
выступать: выступаем выступает
главный: главных главными главная главной главный главным
хлор: хлора
стабильность: стабильность стабильности
углекислотный: углекислотной
высказывать: высказывали
предположение: предположения
следовой: следовых
0203: 0203
миллиард: миллиарда миллиард
единица: единице единиц
объём: объемах объёму объем объёма объема объём объёмом
ppbv: ppbv
удаваться: удавалось
2020го: 2020го
полгода: полгода
северный: северную северном
полушарие: полушарии
глобальный: глобальным глобальном глобальная глобальных глобальное глобальной
пылевой: пылевых пылевая
буря: бурь буря бури бурей
поднимать: поднимала
пыль: пыль пыли
3050: 3050
поверхность: поверхностей поверхностью поверхности
прохождение: прохождению
перигелий: перигелий
близкий: ближайшее ближайшем ближайшие ближайшую
точка: точек точки точку точке
кораблёва: кораблёва
разнести: разнести
что: чему чего что
обнаруженлиния: обнаруженлинии
поглощение: поглощения
хлорводород: хлорводорода
марсавслед: марсавслед
последовать: последовала
малый: меньших малых наименьшие меньшими
размер: размером размера размере размер размеров
наличие: наличие наличия
средний: средняя средних
широта: широтах
колебаться: колебалась
4: 4
окончание: окончания
пылев: пылевой
перестать: перестали перестал
детектировать: детектируют детектировать
следовать: следует следовать следуют
представление: представления
неясно: неясно
откуда: откуда
браться: берётся
уходить: уходит
acsучёный: acsучёные
выдвигать: выдвигают
основной: основные основной
гипотеза: гипотезы гипотезе гипотезу
подниматься: поднимается
выделяться: выделяется
активный: активной активное активного активных
вулканизм: вулканизма
оба: обе обоих обеих оба
недостаток: недостатков недостатки недостаток
механизм: механизм механизмов
превращение: превращения
минерал: минералов
непонятный: непонятен
возникать: возникают возникать возникает
сейсмический: сейсмической
объяснять: объясняют объясняет
пропадать: пропадает
существовать: существует существуют
некий: некое
взаимодействие: взаимодействие
учитываться: учитывалось
продолжать: продолжают продолжает
надеяться: надеется надеются надеюсь
достаточный: достаточные достаточным
разгадка: разгадки
epic: epic
games: games
персонаж: персонажей
metahuman: metahuman
creator: creator
реалистичный: реалистичные
человеческий: человеческих человеческими человеческого человеческим
мимика: мимики
движок: движке движка
unreal: unreal
engine: engine
прямо: прямо
браузер: браузерах браузеров браузера браузеры браузер браузере
значительно: значительно
сократить: сократить сократит сократила
требоваться: требовалось требуется
желать: желающий желающих желающему
пк: пк
pixel: pixel
streaming: streaming
менять: менять
черта: черты
анимировать: анимировать анимированных
волос: волоса волос
цвет: цвета цвет цветом
зуб: зубов
18: 18
телосложение: телосложений
причёска: причёсок
образец: образцов образцы
одежда: одежды
обещать: обещает обещала
расширять: расширять
адаптировать: адаптировать
нужда: нужды
quixel: quixel
bridge: bridge
захват: захвата
манипулировать: манипулировал манипулировать
поддерживать: поддерживают поддерживает поддерживающих поддерживать поддерживающее
анимирование: анимирования
link: link
face: face
вицепрезидент: вицепрезидента вицепрезидент
владимир: владимира
мастилович: мастиловича
десятилетие: десятилетия десятилетие
тратить: тратить
усилие: усилий
ранний: раньше раннего ранних ранние раннем
store: store
qualcomm: qualcomm
5gмодем: 5gмодем
гбит/с: гбит/с
snapdragon: snapdragon
x65: x65
модем: модема модем
5g: 5g
скачивание: скачиваний скачивание скачиванию скачивания
автономный: автономного автономная автономных
неавтономный: неавтономных
предшественник: предшественника предшественников
х60: х60
превышать: превышает превышал
75: 75
сравнение: сравнении сравнению сравнения
чипсет: чипсет
mediatek: mediatek
m80: m80
максимальный: максимальную
77: 77
huawei: huawei
balong: balong
5000: 5000
65: 65
отмечаться: отмечается
стандарт: стандартах стандартам стандарты стандарт
ежемесячный: ежемесячная ежемесячного
потребление: потребления потребление
22: 22
гб: гб
превышение: превышением превышения
лимит: лимита лимитов
ограничиваться: ограничивается
совместимый: совместимы совместимым
спецификация: спецификациями спецификациям
3gpp: 3gpp
release: release
улучшить: улучшенную улучшенные
mimo: mimo
энергопотребление: энергопотребление энергопотребления
позиционирование: позиционирование
развёртывание: развертывания развертывание
промышленность: промышленности промышленность
включать: включают включающему включать включаемых включает включали
нелицензированный: нелицензированного
спектр: спектра
непубличный: непубличных
архитектура: архитектуры архитектура архитектуре архитектур архитектурой
модемный: модемной
обновляться: обновляться обновлялась
хотя: хотя
заморозить: заморожено заморожен заморозили заморозило
дополнительный: дополнительное дополнительным дополнительные дополнительными дополнительной дополнительного дополнительную
протяжение: протяжении
жизненный: жизненного
цикл: цикла
загружать: загружаемым загружаемых загружали загружают загружает
прошивка: прошивки прошивка
анонсировать: анонсировала
x62: x62
антенна: антенну антенне антенны
гигабит: гигабит
наконец: наконец
qtm: qtm
545: 545
mmwave: mmwave
диапазон: диапазонов диапазон диапазонам диапазона диапазонах диапазоне
производительность: производительность производительности
точнее: точнее
держать: держит держать
телефон: телефоны телефон телефонов
wus: wus
оно: оно
флагманский: флагманской
однокристалльный: однокристалльной
приобретение: приобретении приобретения
nuvia: nuvia
стартап: стартапа стартап стартапов
процессор: процессора процессорами процессорах процессоров процессором процессоры процессор
обработка: обработка обработке обработки обработку
рассчитывать: рассчитывает рассчитывают
чип: чипах чипы чип чипами чипе чипа чипом
ориентировать: ориентированный ориентированные
888: 888
смартфон: смартфоны смартфонах смартфон смартфона смартфонов
samsung: samsung
galaxy: galaxy
s21: s21
5нм: 5нм
техпроцесс: техпроцессу
ядро: ядра ядрам
cortexx1: cortexx1
a78: a78
a55: a55
беспроводный: беспроводные
wifi: wifi
6e: 6e
перед: перед
утечь: утекших
файл: файл файлу файла файлы файлам файлами файлах файлов файле файлом
примечательно: примечательно
датировать: датирована
вчера: вчера
указать: указала указано указали
193: 193
разведка: разведки разведка
dlbi: dlbi
ашот: ашот
оганесян: оганесян
сегодня: сегодня
утром: утром
форум: форума форум форуме
4chan: 4chan
выложить: выложена выложили
218: 218
архив: архив архива
игра: игры игра игр
gwent: gwent
witcher: witcher
card: card
game: game
зашифровать: зашифрованы
сохраниться: сохранились
резервный: резервные
восстановление: восстановления восстановление
ps5: ps5
дрифт: дрифт
стиковый: стиков
dualsense: dualsense
playstation: playstation
массово: массово
геймпадов: геймпадов
полмесяца: полмесяца
покупка: покупки покупку покупке
консоль: консоли консолей
приводить: приводит
аналоговый: аналоговые
стик: стики
неправильно: неправильно
игрок: игроках игрока игрокам игроков
срабатывать: срабатывают
касание: касания
reddit: reddit
управиться: управиться
джойстик: джойстиком
destiny: destiny
за: за
immersion: immersion
joycon: joycon
nintendo: nintendo
switch: switch
объявить: объявит объявлен объявил объявила
пострадать: пострадавшим пострадавших
ремонт: ремонт
компенсация: компенсация компенсацию компенсации
обращаться: обращаться
гарантийный: гарантийные
обязательство: обязательства
доставка: доставку доставки доставкой
геймпада: геймпада
заплатить: заплатит заплатить
sony: sony
комментировать: комментирует
ситуациюкомпания: ситуациюкомпания
контроллер: контроллер
тактильный: тактильную
обратный: обратную обратные обратной
драйвер: драйвере драйвер драйверах
hidplaystation: hidplaystation
linuxсистема: linuxсистемах
tsmc: tsmc
дисплей: дисплею дисплея дисплеями дисплеи дисплеев
поколение: поколения
arочки: arочков
vrгарнитур: vrгарнитур
nikkei: nikkei
сотрудничество: сотрудничество сотрудничестве
taiwan: taiwan
semiconductor: semiconductor
manufacturing: manufacturing
co: co
micro: micro
oled: oled
устанавливаться: устанавливаются устанавливаться
непосредственно: непосредственно
пластина: пластина пластине пластины
микросхема: микросхему микросхем
стеклянный: стеклянные стеклянной
подложка: подложки
тонкий: тоньше тонкие
энергоэффективный: энергоэффективные
идеально: идеально
подходить: подходят подходит
очки: очки
glasses: glasses
слух: слухам
ожидаться: ожидается ожидалась
2023: 2023
сверхкомпактный: сверхкомпактных
качественный: качественных
прототип: прототипы прототипов
ультрасовременный: ультрасовременных
секретный: секретный секретных секретной
фабрика: фабрика фабрику фабрике
тайвань: тайване
стадия: стадии
пробный: пробного пробным
вероятно: вероятно
лаборатория: лабораторий лаборатории
парка: парке парки
лонгтан: лонгтан
специализироваться: специализирующихся специализируется
отображение: отображения
учреждение: учреждений учреждения учреждениям
расположить: расположенных расположены расположена
ходьба: ходьбы
завод: завода заводах заводов заводы
нанимать: нанимает
специалист: специалистов специалисты специалиста специалистам
au: au
optoelectronics: optoelectronics
microled: microled
подчиняться: подчиняются
строгий: строгим строгой
соглашение: соглашениям соглашение соглашения
неразглашение: неразглашении
друг: друг другом друзьями друга
знакомый: знакомые знакомыми
направить: направлено направлены направила
снижение: снижения снижение
зависимость: зависимостей зависимости
electronics: electronics
основный: основная основного основным основных
oledдисплей: oledдисплеев
iphone: iphone
лето: летом
высококачественный: высококачественных высококачественные
watch: watch
ipad: ipad
сми: сми
поробность: поробности
гарнитур: гарнитуре
виртуальный: виртуальных виртуальное виртуальной виртуальный
реальность: реальности
оснастить: оснащенными оснащена оснащен оснащенных оснащено
десять: десятью десяти
отслеживание: отслеживания отслеживание
8k: 8k
vrшлем: vrшлема vrшлем
функционировать: функционировать
дополнить: дополненной
путь: путь путями пути
конечный: конечной конечном
лёгкое: легкому
arустройство: arустройству
неотличимый: неотличимые неотличимы неотличимому
очко: очков
старший: старший
аппаратный: аппаратных аппаратной аппаратная аппаратного
дэн: дэн
риччио: риччио
заниматься: занималась занимается
ar: ar
vrустройство: vrустройств
уточнить: уточнено уточнили уточнила уточнил уточнило
предстоить: предстоить
решать: решает решать
начальный: начальной начального начальном начальному
проектирование: проектирования
instagram: instagram
превью: превью
европа: европы европе
талал: талал
хадж: хадж
бакри: бакри
томми: томми
майск: майск
показ: показ
messenger: messenger
соответствие: соответствия соответствии
европейский: европейских европейской
директива: директивой директиве
конфиденциальность: конфиденциальность конфиденциальности
содержимое: содержимое
сохранять: сохраняя сохраняли сохранять
отвергнуть: отвергли
претензия: претензии
относительно: относительно
инфраструктура: инфраструктур инфраструктуре инфраструктуры
отключать: отключать
речь: речи речь
сообщаться: сообщалось сообщается
предел: пределами предел пределах
локальный: локальной локальными локального локальный
выяснить: выяснить выяснила выяснили
хранить: хранят хранит
отправить: отправим отправленных отправят отправленная
отправляться: отправляется
снова: снова
создаваться: создаются создается
значит: значит
либо: либо
сохранный: сохранен
кэшировать: кэширован
почему: почему
отключить: отключить отключили отключена
еспредварительный: еспредварительный
просмотр: просмотре просмотр просмотра
кстати: кстати
поделиться: поделимся поделились поделиться поделятся
улучшение: улучшениями улучшения улучшению улучшение
личный: личных личную личные личной личными
явный: явного
регулироваться: регулируется
ибисследователь: ибисследователи
предупреждать: предупреждают предупреждает предупреждать
регион: региона регионах регионы регионам регионов
воздерживаться: воздерживаться
отправка: отправкой отправки
зонд: зондов зонд
оаэ: оаэ
успешно: успешно
альамаль: альамаль
надежда: надежда надежде надежду
объединить: объединили объединенных объединенной
арабский: арабских
эмират: эмиратов
сбросить: сбросил
манёвр: маневров маневр
график: графику графиком
мохаммед: мохаммед
бин: бин
рашид: рашид
аль: аль
мактум: мактум
twitter: twitter
снизить: снизить снизил
120: 120
км/ча: км/ч
реактивный: реактивных
двигатель: двигателей
deltav: deltav
27: 27
замедление: замедления
al: al
amal: amal
опасный: опасная опасна опасны опасный опасным
подвергнуться: подвергся подверглись
давление: давлению давление давления давлением
собирать: собираем собирать собирают
снизиться: снизиться
emirates: emirates
exploration: exploration
imager: imager
exi: exi
устойчивый: устойчивой
излучение: излучению
снимать: снимает снимать
12мегапиксельный: 12мегапиксельные
радиометрический: радиометрическую
калибровка: калибровку
представлять: представляют представляет представляем представляющий
себя: собой
сборка: сборка сборку сборок сборки сборке
линза: линзы линзу линзой линза линз
оптический: оптическими
uv: uv
vis: vis
искажение: искажений искажение
датчик: датчик датчиков
180: 180
желание: желании желание
4k: 4k
emus: emus
emarates: emarates
mars: mars
ultraviolet: ultraviolet
spectrometer: spectrometer
ультрафиолетовый: ультрафиолетовым
прибор: приборах прибор
выполнение: выполнении выполнения
emm: emm
термосферный: термосферной
100200: 100200
экзосферной: экзосферной
изменчивость: изменчивости изменчивостью
emirs: emirs
интерферометрический: интерферометрический
термальный: термальный
инфракрасный: инфракрасный
энергетический: энергетический энергетические
баланс: баланс
климат: климате
циркуляциейнадежда: циркуляциейнадежда
совершать: совершать
виток: виток
55: 55
часовэтый: часовэто
космос: космосе космос
пролететь: пролетел
свыше: свыше
480: 480
три: трёх трех
достигнуть: достигнуть достигла
аппаратывластить: аппаратывласти
луна: луну луны
приземлиться: приземлиться
2024: 2024
район: районов районах
охватить: охваченных
снимок: снимки
стрим: стрим стримом стрима
phpразработчик: phpразработчиков
никита: никита никитой
попов: попов поповым
skyeng: skyeng
30554: 30554
онлайншкола: онлайншкола
читатель: читателей
хабов: хабов
php: php
событие: событий события событиях событиями
запомниться: запомнились
2020м: 2020м
кто: кому кого кто
читать: читайте читали
слушать: слушали
набраться: набралось
1500: 1500
позвать: позвать
частый: частые чаще
упоминать: упоминали упоминает
поговорить: поговорим поговорить
явление: явлением явлениях
разыграть: разыграем
пара: пара пару
фирменный: фирменных фирменные
слон: слонов слоны
ценный: ценным ценных
полезный: полезные полезного полезными полезной полезных
просто: просто
приятный: приятных приятное приятным
приз: призы призов
активист: активистов
ну: ну
добавить: добавит добавлены добавлена добавлен добавили добавить добавленный добавила
свежий: свежих
доклад: доклады докладов
когда: когда
суббота: суббота
утро: утра
москве/минск: москве/минску
киев: киеву
point1110: point1110
пилить: пилить
видеозвонок: видеозвонки
устроенный: устроен
фронт: фронт
бэк: бэк
решенийилья: решенийилья
левин: левин
поднять: поднять
видеоконференция: видеоконференцию
база: базами базе база базы
webrtc: webrtc
janus: janus
1150: 1150
роман: романа роман романом
пронский: пронского
валентин: валентином валентин
удальцов: удальцов удальцовым
пых: пых
жук: жук
скобка: скобок
мязина: мязин
пятиминутка: пятиминутка
николай: николай
сумрак: сумрак
today: today
константин: константин
буркалев: буркалев
sdcast: sdcast
околеловый: околелов
думать: думали думаю
завести: завести
пробовать: пробовали
полететь: полетело
или: или
давно: давно
ребята: ребят
спросить: спросить
текст: текстом текст текста
ютуба: ютубе
голос: голосом
1230: 1230
тандем: тандем
grpcантон: grpcантон
php/go: php/go
manychat: manychat
заложить: заложенных заложить
фундамент: фундамент
масштабирование: масштабирование масштабирования
grpc: grpc
protobuf1310: protobuf1310
ждать: ждут ждет ждать
2021м: 2021м
елисеев: елисеев
александр: александр
макаров: макаров
обсудить: обсудим обсудят
1340: 1340
почитать: почитать
посмотреть: посмотрим посмотреть
представимый: представим
топ: топе топ
опрос: опроса
авторами1420: авторами1420
раздача: раздача
подведение: подведение
минувший: минувшего
phpгод: phpгода
презентовать: презентуют презентовать
разыгрывать: разыгрывали разыгрывать
подарок: подарки
phpдайджест: phpдайджеста
футболка: футболки
rndphp: rndphp
rnd: rnd
tech: tech
худить: худи
badoo: badoo
книга: книги книге
yola: yola
phpstorm: phpstorm
laravelidea: laravelidea
часовой: часовые часовую часовом
консультация: консультации консультацию
сало: сала
drupalкомьюнити: drupalкомьюнити
озвучить: озвучим озвучено
частиps: частиps
девреловый: деврелов
роспотребнадзор: роспотребнадзором роспотребнадзор роспотребнадзора
запретить: запрещенная запретила запрещенный запрещенной запрещенную запретить запретит запрещенного запретил запретили запрещенным запрещены запрещено
школьник: школьников школьникам
санитарный: санитарным санитарных санитарного санитарные
ребёнок: детям детей дети
школьный: школьного школьные
возраст: возраста
образовательный: образовательный образовательных
риа: риа
общественный: общественного общественным общественных
слушание: слушаний
воспитание: воспитания
отдых: отдыха
оздоровление: оздоровления
молодёжь: молодежи
начальник: начальник начальника
управление: управление управления управлении
надзор: надзора
ирина: ирина
шевкун: шевкун
брать: брать
школа: школу
родитель: родителями
общение: общение общения
запрещаться: запрещается
планшет: планшеты
моноблок: моноблоки
интерактивный: интерактивные
доска: доски
ограничение: ограничения ограничение ограничений
шевкундиректор: шевкундиректор
нии: нии
гигиена: гигиены
охрана: охраны
владислав: владислав
кучма: кучма
80: $80 80 80%
учиться: учатся учащихся
экран: экрана экране экран экраном
увеличивать: увеличивает
зрение: зрения зрение зрению
дюйм: дюймов
шрифт: шрифта
взломать: взломал взломанные взломали
itкомпания: itкомпаний
путём: путём путем
атака: атака атаке атак атаку атаки
цепочка: цепочку цепочки
алекс: алексу
бирсан: бирсану бирсана бирсан
внутренний: внутренним внутренней внутренние внутренняя внутренних внутренний
paypal: paypal
shopify: shopify
netflix: netflix
yelp: yelp
tesla: tesla
uber: uber
вредоносный: вредоносного вредоносное вредоносными вредоносные вредоносных вредоносный вредоносным
репозиторий: репозитория репозиториях репозитории репозиториев репозиторий
pypi: pypi
npm: npm
rubygems: rubygems
целевой: целевой
никакой: никакого никаких
конструктивный: конструктивный
экосистема: экосистему экосистем
путаница: путаница
эксплойт: эксплойт
130: $130 130
вознаграждение: вознаграждений вознаграждения вознаграждение
манифест: манифестов манифеста
packagejson: packagejson
пакет: пакет пакетов пакета пакеты пакетами
общедоступный: общедоступном общедоступных общедоступные
частный: частном частными частное частные частной частных
тогда: тогда
github: github
cdn: cdn
известный: известная известный известных
поддельный: поддельный поддельные поддельной
каждый: каждого каждый каждую каждой каждая каждые каждым
выходить: выходит выходил
учётный: учетной учётной учетные
запись: запись">"тема запись записи записью
пояснение: пояснением
содержать: содержащие содержать содержали содержат содержит
вскоре: вскоре
публичный: публичное публичные публичных публичная публичный публичной
приоритет: приоритет
извлечь: извлечен
какихлибо: какихлибо
успешный: успешную
сценарий: сценариях сценарий сценарию сценарии
предварительный: предварительного предварительные предварительной
извлечение: извлечение
знать: знает знаю зная знать знаете
устанавливать: устанавливать
соединение: соединения
корпоративный: корпоративную корпоративная корпоративных
dns: dns
эксфильтрация: эксфильтрации
обойти: обошел обойти
проникнуть: проник
подчёркивать: подчеркивает
организация: организация организации
частное: частного
40: $40 40 40%
cve202124105: cve202124105
azure: azure
artifactory: artifactory
​​путём: ​​путем
перенастройка: перенастройки
публично: публично
обнародовать: обнародовали обнародовала
отчёт: отчёта отчёте отчетов отчету отчет отчёты отчете
упоминаться: упоминается
сумма: суммы сумму сумма
python: python
software: software
дастина: дастин
инграм: инграм
повод: поводу поводом
размещать: размещает размещать
сторонний: сторонней сторонние сторонних
подчеркнуть: подчеркнула подчеркнул
незаконный: незаконном незаконной незаконных незаконным
ложиться: ложится
бремя: бременем
sonatype: sonatype
скрипт: скрипты скрипт
nexus: nexus
repository: repository
manager: manager
сравнить: сравнить сравнила
вебинар: вебинары вебинара вебинар вебинаре вебинарах
эффективность: эффективности эффективность
термообработка: термообработки
приглашать: приглашаем
посетить: посетить
1100: 1100
московский: московскому
временитермический: временитермическая
энергозатратный: энергозатратный
огромный: огромное огромного огромно
ресурс: ресурсом ресурсы ресурса ресурсах ресурсов
влиять: влияющих влияют влияет
себестоимость: себестоимость
продукция: продукции продукцию
брак: брака
трата: тратам
повторный: повторный повторного
уверенность: уверенности
соблюдение: соблюдении
постоянный: постоянный
термический: термической
стандартный: стандартного стандартных стандартными
хватать: хватало хватает
вещь: вещей
pims: pims
обработкиприсоединяться: обработкиприсоединяйтесь
успех: успехи успеха успехах
познакомиться: познакомиться
вид: видами виде видов вид виду
программирование: программирования
преимущество: преимущество преимущества преимуществ преимуществом
вопросыучастие: вопросыучастие
заполнить: заполните
регистрациирегистрация: регистрациирегистрация
https//winnumtimepadru/event/1553660/: https//winnumtimepadru/event/1553660/
adobe: adobe
одновременный: одновременной одновременную
photoshop: photoshop
illustrator: illustrator
fresco: fresco
пригласить: пригласить
редактирование: редактирование
необходимо: необходимо
сохранить: сохранить сохранит
psd: psd
ai: ai
электронный: электронное электронного электронной электронные электронный
почта: почты почту
получиться: получится получился
редактировать: редактируемому редактирует
дождаться: дождаться
завершение: завершении завершения
соавтор: соавторам соавторы
открыть: открыть открыт открыла открыта
синхронизироваться: синхронизируются
подключиться: подключиться подключится
приступить: приступит приступить
чтоть: чтото
ос: ос
синхронизация: синхронизация синхронизации
пресет: пресетами пресетов
перенос: переноса
начинать: начиная начинали
подключить: подключена подключить подключены
creative: creative
cloud: cloud
отдельно: отдельно
облачный: облачными облачного облачные облачных
4096: 4096
2318: 2318
starlink: starlink
предзаказ: предзаказов предзаказа предзаказы
ограниченный: ограниченным ограниченной ограниченных ограниченную ограниченному
слот: слоты слотов
приём: прием
спутниковый: спутникового спутниковой спутниковых
приниматься: принимаются
очередь: очередь очереди
запрос: запросам запрос запросы запроса запросу запросов
скорый: скором скорое
заявка: заявкам заявке заявки заявку заявок
выполниться: выполнятся
порядок: порядке порядку порядка порядок
группировка: группировке группировки
узел: узел узлов узле
покрытие: покрытия
рассылать: рассылает
зарезервировать: зарезервировать
будущий: будущей будущую будущие
депозит: депозита депозит
99: $99
комплект: комплекты комплект комплекта
случиться: случиться случился случилась случись
спустя: спустя
долгий: долгими долгого дольше
середина: середине
размещение: размещения размещение
гарантировать: гарантировать гарантирует
возвратить: возвращен
бетатестирование: бетатестирование бетатестирования бетатестированию
тестер: тестеров тестер
плюс: плюсов плюс
терминал: терминал терминале
фара: фар
маршрутизатор: маршрутизатор
499: $499
50: 50 $50
север: севере
интернетсервис: интернетсервиса
рубеж: рубежом
илона: илон
маск: маск
одобрение: одобрение
ожидать: ожидает
положительный: положительного
евросоюз: евросоюза
выводить: выводит
миниспутник: миниспутников
покрыть: покрыть
америка: америку
состав: составе
околоземный: околоземном
миллисекунда: миллисекунды миллисекунд
рекорд: рекорде
190: 190
мбит/с: мбит/с
заключить: заключила заключили заключить заключило
3318: $3318
лунный: лунной лунных лунную
gateway: gateway
аэронавтика: аэронавтике
окололунный: окололунной окололунная
электродвигательный: электродвигательный электродвигательного
жизнеобеспечение: жизнеобеспечения
снабжение: снабжения
пересадочный: пересадочным
пункт: пунктом
артемида: артемида
power: power
and: and
propulsion: propulsion
element: element
ppe: ppe
питание: питанием питания питание
диспетчерский: диспетчерским
ориентация: ориентацией ориентацию
построить: построенной построит построят построили построенный
maxar: maxar
technologies: technologies
вестминстер: вестминстера
habitation: habitation
logistics: logistics
outpost: outpost
halo: halo
разрабатываться: разрабатывается разрабатывался
northrop: northrop
grumman: grumman
проживание: проживания
посещать: посещают посещаемых посещать
собрать: соберут собраны
космодром: космодрома
мыс: мысе
канаверал: канаверал
сверхтяжёлый: сверхтяжёлой
ракета: ракеты ракетой ракет
falcon: falcon
heavy: heavy
раз: раз раза
превосходить: превосходит
предприниматель: предпринимателям предпринимателя предприниматель
пуск: пуска
а: а
объявлять: объявлять объявляли
ракетыноситель: ракетыносителя
психея: психея
117: $117
связать: связанная связано
располагаться: располагаться
разместить: размещенному разместив разместят размещены размещенным размещен размещенный
лагранж: лагранжа
l2: l2
near: near
rectilinear: rectilinear
orbit: orbit
километр: километрах километров
шестой: шестую шестой
прибывать: прибывать
спускаться: спускаться
прилунение: прилунения
угроза: угроза угроз угрозой угрозу
нацбезопасность: нацбезопасности
китайский: китайских китайского китайская китайский китайскими китайским китайской китайские
иск: иск иске искам иска
признание: признание
просить: просят просит
прошлогодний: прошлогоднее
комиссия: комиссию комиссии комиссия
fcc: fcc
вынести: вынесенное
произвольный: произвольного произвольный произвольным
капризный: капризным
злоупотребление: злоупотреблением
полномочие: полномочиями полномочий
окончательный: окончательное окончательный
значительный: значительного значительном значительный значительным
подача: подачи
топменеджмент: топменеджмент
выразить: выразил
администрация: администрации администрация
джо: джо
байден: байдена
изложить: изложила
подход: подход подходе
министр: министра
торговля: торговли
джина: джина
раймондо: раймондо
защитить: защитить защищены
политик: политиков политик
торопиться: торопился торопиться
чёрный: черного
опасность: опасность опасности
внешний: внешние внешним внешнему внешней внешний
intel: intel
отзывать: отзывают
бюджетный: бюджетных
honor: honor
консорциум: консорциуму
агент: агентов
дилер: дилеров
санкция: санкций
disney: disney
закрывать: закрывает
blue: blue
sky: sky
walt: walt
company: company
закрыть: закрыла закроет закрыть
мультфильм: мультфильма мультфильмы мультфильмов
ледниковый: ледниковый
рио: рио
фердинанд: фердинанд
издание: издания издание изданию
deadline: deadline
апрелестудия: апрелестудия
объяснить: объяснить объяснили объяснила
головной: головных головного головной
понести: понесли понесла
потеря: потере потери
квартал: квартале квартал
сообщить: сообщили сообщила сообщил
выручка: выручке выручек выручки выручка
доллар: долларов
вполовину: вполовину
202: 202
млрдизз: млрдизза
карантинный: карантинных
развлекательный: развлекательные
убыток: убытки убытков
предотвратить: предотвратить
счёт: счёт счетах счет
популярность: популярности популярность
стриминговый: стримингового
disney+: disney+
зарегистрироваться: зарегистрировалось
зрителейстудия: зрителейстудия
уволить: уволит уволила уволили
450: 450
вакансия: вакансии
подразделенияхdisney: подразделенияхdisney
skyстудия: skyстудию
1987: 1987
кристофер: кристофер
уэдж: уэдж
гополакрашнать: гополакрашнан
фильм: фильма фильмов фильм фильмах
трон: трон
двадцатый: двадцатый
век: век
фокс: фокс
приобрести: приобрести приобрел приобрёл приобрела
1997: 1997
2002: 2002
полнометражный: полнометражный
анимационный: анимационный
периоддый: периоддо
рекламный: рекламные рекламный рекламного рекламных
продемонстрировать: продемонстрировать продемонстрировала
мягкий: мягких
тень: теней
трекинг: трекинг
применение: применения применение
полигон: полигонов
твердотельный: твердотельного
моделированиять: моделированияв
1990: 1990
освещение: освещением
сцена: сценах
отражение: отражениями
преломлениямифотореалистичный: преломлениямифотореалистичные
привлечь: привлек привлечь привлекла привлекли
внимание: внимания вниманию внимание
киностудия: киностудий
голливуд: голливуда
нанять: наняли
эффект: эффектами эффекта
квартирка: квартирка
1996: 1996
бойцовский: бойцовский
клуб: клуб
1999мультфильм: 1999мультфильм
шпион: шпионы
прикрытие: прикрытием
уиллом: уиллом
смит: смитом
том: томом
холланд: холландом
мультипликационный: мультипликационной
прокат: прокат
кассовый: кассовый
картина: картины
158: 158
бюджет: бюджет бюджете
word: word
тестировать: тестирует
тёмный: тёмный тёмным тёмного тёмном тёмная
бумага: бумагами бумаг бумагам бумаги
функционал: функционала функционал
office: office" office
поле: поле поля
остальной: остальные остального остальной остальных остальном
интерфейс: интерфейс интерфейса
ночью: ночью
яркий: яркий ярких яркие
навредить: навредить
исправиться: исправиться
холст: холста
зайти: зайти
переключаться: переключается
вкладка: вкладок вкладке
панель: панели
кнопка: кнопке кнопки
переключить: переключить
оттенок: оттенки
соответствующий: соответствующие соответствующих
светлый: светлой
увидеть: увидят
цвета: цветами
2012: 2012
1351810000: 1351810000
протестировать: протестировать
дыра: дыру дырах
sudo: sudo
уязвимость: уязвимостей уязвимости уязвимость уязвимостях
big: big
sur: sur
вызвать: вызвали вызвала вызвать вызвало вызвавшее
перезаписать: перезаписать
argv: argv[0]
символический: символическую
подвергнуть: подвергнет
rootуязвимость: rootуязвимости
mojave: mojave
исправлять: исправляют
критический: критических критическую критической
обсуждать: обсуждать обсуждали обсуждают обсуждала
расследование: расследование
установить: установив установить установит установят установила установлен
непропатченный: непропатченных
привилегия: привилегий привилегиями привилегии
устранить: устранила устранена устранить
195p2: 195p2
bleeping: bleeping
computer: computer
графический: графические графических
ввиду: ввиду
серьёзность: серьезности серьёзности
настоятельно: настоятельно
hacker: hacker
house: house
многолетний: многолетнюю
112: 112
10146: 10146
курс: курс курсе
qualys: qualys
утилит: утилите утилиты
ubuntu: ubuntu
debian: debian
fedora: fedora
root: root
/etc/sudoers: /etc/sudoers
непривилегированный: непривилегированном
2011: 2011
сбербанк: сбербанк сбербанка
cognitive: cognitive
сп: сп
pilot: pilot
регулировать: регулировало регулирующий регулирующее регулируют
дорога: дорогах дороги
сппо: сппо
собеседник: собеседника
газета: газета газеты
законодательный: законодательная законодательных
регламентировать: регламентируют
авто: авто
подзаконный: подзаконных
1015: 1015
интервью: интервью
разобраться: разобрались разобраться
бизнесмодель: бизнесмоделями
вестись: велась вестись ведётся велись
реализация: реализации реализация
800: 800
сравнимый: сравнимого сравнимо
недорогой: недорогой
иномарка: иномаркой
несмотря: несмотря
отказываться: отказывается отказываться
продолжить: продолжит продолжат
пдд: пдд
машина: машин машиной машинами
привлечение: привлечения привлечении привлечением
forward: forward
legal: legal
людмила: людмила
лукьянов: лукьянова
страховка: страховку
особенность: особенности особенностей особенностью
фиксация: фиксации
дтп: дтп
определение: определение определения
возмещение: возмещения
смысл: смысл смысле
измениться: измениться изменилось
налоговый: налоговые
перспектива: перспективы перспектив перспективе
назад: назад
венчурный: венчурной венчурного
молодой: молодых
инвестор: инвесторов инвесторам инвесторы
обыватель: обыватели
большинство: большинству большинство большинстве
торговаться: торгуется торгующиеся торгуются
биржа: бирже биржу биржам
готовность: готовность
вкладывать: вкладывать
деньга: деньги деньгах денег
j: j’son
partners: partners
consulting: consulting
долго: долго
2035: 2035
половина: половины половина
автопилот: автопилота
аналитик: аналитику аналитики аналитик
владеть: владеет
менеджмент: менеджмент
сognitive: сognitive
нацелить: нацелен нацелена нацеленной
сельскохозяйственный: сельскохозяйственной
поезд: поездами
безналичный: безналичную безналичной
yandex: yandex
pay: pay
vtimes: vtimes
банковский: банковских банковские
карта: карт карты
вебстраница: вебстраницах
там: там
уточняться: уточняется
авторизовать: авторизованные
пользоваться: пользовались пользоваться пользовался пользуется пользуются
платёжный: платежной платёжные платежным платежная
сервисомпока: сервисомпока
весна: весной
подать: подал поданных подала
ябанк: ябанк
ятрейд: ятрейд
явалюта: явалюта
переговоры: переговоров переговоры переговорами
тинькофф: тинькофф
неудачный: неудачными неудачных неудачные
тиньковы: тиньков
яндексденьга: яндексденьги
называться: называется
юmoney: юmoney
центробанк: центробанк
расчёт: расчетов
блокировка: блокировки блокировку блокировка
платёж: платежи
онлайнказино: онлайнказино
онлайнигра: онлайниграх
серый: серыми
букмекер: букмекерами
kubernetes: kubernetes
разработки…: разработки…
отладить: отлажены
приходить: приходят приходите приходит
1900: 1900
кластер: кластере
уменьшить: уменьшить
k8s: k8s
сокращаться: сокращается
timetomarket: timetomarket
вообще: вообще
марсель: марсель
ибрай: ибраев
сто: сто
бондарев: бондарев
архитектор: архитектор
селиван: селиванов
senior: senior
devopsинженер: devopsинженер
mailru: mailru
solutions: solutions
лазаренко: лазаренко
гамов: гамов
developer: developer
advocate: advocate
confluent: confluent
четверг: четверг
задать: задать
прислать: пришлём присланного прислать
отдел: отделам отдела отдел
нетерпение: нетерпением
должность: должности
сосредоточиться: сосредоточится сосредоточиться
чеготь: чегото
прекрасный: прекрасный прекрасного
назначение: назначение назначении назначения
напоминать: напоминает
фил: филом
шиллер: шиллером
уйти: уйти ушедших ушел ушедший
маркетинг: маркетинг маркетинга маркетингу
переключиться: переключился
app: app
общественность: общественностью общественности
отчитываться: отчитываться
тим: тимом
кук: куком
топменеджер: топменеджер
джон: джон
тернус: тернус
трудиться: трудится
intellij: intellij
idea: idea
conf: conf
продуктивный: продуктивной
jetbrains: jetbrains
14283: 14283
эффективный: эффективнее эффективной эффективную эффективные
исполняться: исполняться исполняется
отпраздновать: отпраздновать
знаменательный: знаменательную
онлайн: онлайн
конференция: конференцию конференциях
2526: 2526
годаприглашать: годаприглашаем
присоединиться: присоединиться
двухдневный: двухдневному
эволюция: эволюции
и: [и] и
далеко: далеко
все2: все2
14: 14 $14
сессия: сессий сессии сессиях
спикер: спикеров
перерыв: перерывов
1200: 1200
mskподробный: mskподробнее
докладчик: докладчики докладчиках
английский: английском
вот: вот
расписание: расписание
сессийдеть: сессийдень
2021деть: 2021день
пятница: пятницу пятница
26: 26
2021конференция: 2021конференция
jvmразработчик: jvmразработчиков
продуктивность: продуктивность
ide: ide
jvmразработким: jvmразработкимы
услышать: услышала услышите
лично: лично
поучаствовать: поучаствуете
обучать: обучающий обучающих
многое: многое многого
обязательно: обязательно
себявсе: себявсе
заходить: заходите
регистрироваться: регистрируйтесь регистрировались
посещение: посещения
выбрайт: выбрайте
интересовать: интересуют
записать: записаны записать
забыть: забудьте забыл забыли забудут
заинтересовать: заинтересовала заинтересованы
юзергруппа: юзергруппы юзергруппу
ивента: ивент
jug: jug
присоединяться: присоединяйтесь
лого: лого
среди: среди
не: не
упустить: упустите
пообщаться: пообщаться
хэштег: хэштеги
intellijideaconf: #intellijideaconf
ij20bday: #ij20bday
linkedin: linkedin
пропустить: пропустить пропустите
сессииваш: сессииваша
drive: drive
develop: develop
author: author
русскоязычный: русскоязычными русскоязычный русскоязычные
твиттер: твиттер твиттере
апдейт: апдейтах
происходить: происходит происходить происходящих
qa: qa
automation: automation
engineer: engineer
code: code
me: me
биолог: биологов биологи
лес: леса
потреблять: потреблять потребляют
углекислый: углекислого углекислый
западный: западной
вирджиния: вирджинии
дерево: деревьями деревья деревьев
считаться: считалось
открытие: открытия открытием открытие
важный: важным важные важное важна важных важен
звено: звеном
регулирование: регулирование регулировании регулирования
proceedings: proceedings
national: national
academy: academy
sciences: sciences
профессор: профессор
ричард: ричард
томас: томас
джастин: джастин
матиас: матиас
кольцо: кольцами колец кольцах
содержание: содержания содержание
со2: со2
столетие: столетие
вдыхать: вдыхать
выдыхать: выдыхать
водяной: водяного
уничтожение: уничтожению уничтожение
воздух: воздухе воздуха
геометрический: геометрической
прогрессия: прогрессии
стремиться: стремящихся стремились
эффективно: эффективно
устьичный: устьичной
проводимость: проводимости
влага: влаги
лист: листьях
прикрываться: прикрывались
изотоп: изотопов
углерод: углерода
83: $83 83%
ускорять: ускоряет ускоряли
фотосинтез: фотосинтеза
1901: 1901
2015: 2015
84: 84
участок: участках
сочетание: сочетания сочетании
34: 34% 34 $34
двуокись: двуокиси
характеристика: характеристики характеристикам
1960ха: 1960х
увеличиваться: увеличиваться увеличивались увеличивалась увеличивается
быстрый: быстрому быстрой быстрее
масштаб: масштабам масштабе
серьёзный: серьезные серьезной
углеродный: углеродного
переноситься: переноситься
исследователина: исследователина
вложить: вложить вложил
x: x
prize: prize
связывание: связывания
продлиться: продлиться продлится
победитель: победитель победители
связывать: связывать связывающие
океан: океана океанов
навсегда: навсегда
изолировать: изолировать
экологически: экологически
роскомнадзор: роскомнадзором роскомнадзор роскомнадзора
соцсеть: соцсети соцсеть соцсетях
фгуп: фгуп
радиочастотный: радиочастотный радиочастотные
ркн: ркн
социально: социально
бетаверсия: бетаверсия
идентификация: идентификации идентификацию
аккаунт: аккаунтом аккаунту аккаунт аккаунта
госуслуга: госуслуг
вебсайт: вебсайт вебсайтов вебсайтах вебсайтам
противоправный: противоправного противоправному противоправный
детский: детской
порнография: порнографии
пропаганда: пропаганде пропаганда
суицид: суицидов
наркотический: наркотических
рассмотрение: рассмотрения рассмотрение
проверить: проверили проверить
интернетресурс: интернетресурсам
штраф: штрафов штраф штрафа
неудаление: неудаление
грчца: грчц
замечание: замечаниям замечания
функционирование: функционирования
диагностика: диагностики
телеметрия: телеметрии
хранилище: хранилище хранилища хранилищу
контактный: контактным
обрабатывать: обрабатывать обрабатывает обрабатывая
метаданные: метаданные метаданных
упущение: упущения
дефект: дефекты
передача: передачи передачу передаче
сбой: сбоям сбое сбои
кража: кражу
неправомерный: неправомерный
генпрокуратура: генпрокуратурой
крупно: крупно
оштрафовать: оштрафовать
tiktok: tiktok
вконтакте: вконтакте
одноклассник: одноклассники
видеохостинг: видеохостинг
youtube: youtube
интернетплощадка: интернетплощадки
положить: положенный
170: 170
заблокировать: заблокировала заблокировал заблокирован заблокировать заблокированы заблокировали
сутки: суток сутки
2500: 2500
противоречивый: противоречивые
чувство: чувства
написание: написанием
освежить: освежите
память: память памяти памятью
коечто: коечто
написать: написали написано написать написал написан
выжить: выжить
→: →
пожаловаться: пожаловаться пожаловались
оперативность: оперативность
зловредный: зловредный
сокращать: сокращает сокращая сокращать
материаловк: материаловк
законодательно: законодательно
относиться: относиться относится относятся
тдприложение: тдприложение
дополнять: дополняет
нарушать: нарушают нарушающей
законодательствоз: законодательствоза
профильный: профильным профильного
315: 315
643: 643
оборот: оборот обороте обороты
наркотик: наркотиков
2115: 2115
призыв: призывы призывов призывах
самоубийство: самоубийству
нелегальный: нелегальных
азартный: азартных
играхбетаверсия: играхбетаверсию
скачать: скачать скачали
регистрациитакж: регистрациитакже
направлять: направлять
ermp: ermp@grfcru
тип: типы типа тип типах
dram: dram
ускорить: ускорить
бесконденсаторный: бесконденсаторной
оксидный: оксидных
полупроводник: полупроводники полупроводников полупроводник
трёхмерный: трехмерные
кремний: кремнием
зарекомендовать: зарекомендует
тест: тесте тестов тестах тесты
экономия: экономию экономии
площадь: площадь площади
энергия: энергии
стена: стена
вычислительный: вычислительных
разница: разница
искусственный: искусственные искусственных искусственную искусственного
интеллект: интеллекта
обостриться: обострилась
соединить: соединенных
​​бельгия: ​​бельгии
битый: бит биты
сотня: сотни сотен
чтение: чтения чтение
конденсатор: конденсатор конденсатором конденсатора
обратно: обратно
заряд: заряда заряд
транзистор: транзисторами транзистор транзисторы транзистора
ячейка: ячейки
периодически: периодически
обновлять: обновлять
64: 64
встраивание: встраивание
процессорный: процессорную
изготовление: изготовлении изготовления
сверхнизкий: сверхнизкой
2t0c: 2t0c
затвор: затвора затворы затвор
храниться: храниться хранящегося
конструкция: конструкцию конструкции
схема: схемы схемой схемам схеме схему схема схемами
плохо: плохо
кремниевый: кремниевыми кремниевые кремниевой
логический: логической логическими
исчезать: исчезать
ёмкость: емкость
аморфный: аморфного
оксид: оксиды оксида оксид
ток: ток
пропускать: пропускают
мало: мало
битов: битов
индия: индии индия
легировать: легированный легированного
вольфрам: вольфрамом
оранжевый: [оранжевый]
верхний: верхние верхняя
палладий: палладия
жёлтый: желтые
никелевый: никелевые
электрод: электроды
исток: истока
зелёный: [зеленые]
диэлектрик: диэлектрики
гафний: гафния
синий: [синие]исследователи
imec: imec
iedm: iedm
галлия: галлия
цинк: цинка
полупроводникаподобный: полупроводникаподобные
межсоединение: межсоединений
повреждать: повреждая
4слойный: 4слойная
8слойной: 8слойной
73: 73
1t1c: 1t1c
динамический: динамической
интернетфорум: интернетфорум
стратегический: стратегических
пятый: пятого
раунд: раунда раунд
финансирование: финансирования
250: $250
оценочный: оценочная
6: $6 6
млрд: млрд
2005: 2005
начинание: начинания
многофункциональный: многофункциональные
привлекательный: привлекательные
содержательный: содержательного
многогранный: многогранного
инвестировать: инвестирует инвестировать инвестировала
текстовый: текстовые текстовый текстовом текстовой
обсуждение: обсуждении обсуждения
потоковый: потокового
вещание: вещания
недавно: недавно
dubsmash: dubsmash
увеличиться: увеличились увеличилась увеличился
90: 90 90%
удвоить: удвоить
рекламодатель: рекламодателей
фондовый: фондовом фондового
хеджфонд: хеджфондов
homebrew: homebrew
m1: m1
300: 300
нативный: нативные нативную
silicon: silicon
поддерживаться: поддерживаются
функциикоманда: функциикоманда
волонтёр: волонтёров
недоставать: недостающие
реализовать: реализованные реализовать реализовала реализующие реализовали реализовал
rosseta: rosseta
2издание: 2издания
менеджер: менеджера менеджер
qlimagesize: qlimagesize
окно: окон окно окне
предпросмотр: предпросмотра
libmatio: libmatio
matlabразработчик: matlabразработчики
синтаксис: синтаксис
блок: блоками блок
bottle: bottle
brew: brew
style: style
fix: fix
обновить: обновили обновит обновленную обновить обновленному
формула: формулы
форматменеджер: форматменеджер
утилита: утилита
командный: командной
строка: строки строка строку
упрощение: упрощение
монотонный: монотонных
операция: операций
юань: юаней юанях юаня
праздник: праздниках
пекин: пекина пекине
потратить: потратить
магазин: магазина магазинах
празднование: празднования
шэньчжэнь: шэньчжэнь
сучжоу: сучжоу
ваучер: ваучеров
идентификационный: идентификационный
жительство: жительство
макао: макао
специально: специально
обозначить: обозначенных обозначив обозначили
офлайнмагазин: офлайнмагазинах
величина: величине
онлайнритейлер: онлайнритейлера
jdcomвласть: jdcomвласти
приближение: приближения
зимний: зимних
олимпийский: олимпийских
2014: 2014
целесообразность: целесообразности целесообразность
ввод: ввод
обращение: обращение
усилить: усилить
денежный: денежной денежных денежная
масса: массы
юаняожидаться: юаняожидается
аналогично: аналогично
analysis: analysis
alipay: alipay
alibaba: alibaba
wechat: wechat
tencent: tencent
оправдывать: оправдывает
мти: мти
лазерный: лазерной лазерные лазерную
электроника: электронику электроники
робот: роботов
наука: науки наук
csail: csail
печать: печати
функциональный: функциональных
вмешательство: вмешательства
laserfactory: laserfactory
инструментарий: инструментарий
3dпринтер: 3dпринтеры 3dпринтер
резак: резаки
мартин: мартин
ниссера: ниссер
быстро: быстро
дрон: дрона дрон
проектировать: проектирует
деталь: деталей детали
рисовать: рисует
печатный: печатной
плата: платы плате плату плата
геометрия: геометрия
дорабатываться: дорабатывается
2dредактор: 2dредакторе
машинный: машинное машинного машинные
встраиваться: встраиваются
производственный: производственный
изготовить: изготовить
резка: резки
выполнять: выполняет выполнять
обрезка: обрезку
выбирать: выбирает выбираем выбирают
закреплять: закрепляет
функционально: функционально
немедленно: немедленно
взлететь: взлететь взлетели
разрешать: разрешающую
способность: способность
дорожка: дорожек
3dпечать: 3dпечати
правильно: правильно
mozilla: mozilla
aws: aws
rust: rust
заняться: займется занялись заняться
некоммерческий: некоммерческая
уже: уже
сформировать: сформирован сформированную
долларовrust: долларовrust
грэйдон: грэйдоном
хором: хором
research: research
javascript: javascript
брендать: брендана
эйх: эйха
фундаментальный: фундаментальное фундаментальных
firefox: firefox
gecko: gecko
сокращение: сокращения сокращений
потерять: потеряла потерял
спонсорство: спонсорства
неясный: неясного неясным
войти: войдут
компанийучредитель: компанийучредителей
заседание: заседание
правление: правления
торговый: торгового торговой торговые торговое
марка: марки
cratesio: cratesio
благодарный: благодарны
взращивать: взращивала
независимый: независимой
foundationвсе: foundationвсе
компанииспонсор: компанииспонсоры
профинансировать: профинансирует
вебсервер: вебсервера
apacheть: apacheв
доказать: доказал
многий: многих
среда: средах среды
рада: рады
вклад: вклад
переписывание: переписывания
amazon: amazon
web: web
services: services
bottlerocket: bottlerocket
linuxдистрибутив: linuxдистрибутив
основное: основном
критически: критически
simple: simple
storage: storage
elastic: elastic
compute: compute
cloudfront: cloudfront
затрата: затратами затраты
встраивать: встраиваемой встраивать
субд: субд
libmdbx: libmdbx
093: 093
crowdsec: crowdsec
6876: 6876
it: it
security: security
hosting: hosting
virtual: virtual
environment: environment
высокопроизводительный: высокопроизводительной
libdbx: libdbx
класс: класса классу классов
компактный: компактных
бд: бд
c: c
финансироваться: финансируется
продуктахсубд: продуктахсубд
глубокий: глубокая
материнский: материнский
надёжность: надежности
092важный: 092важным
lmdb: lmdb
create: create
read: read
update: update
delete: delete
достигаться: достигается
сопоставимый: сопоставима сопоставимого
сериализация: сериализации
неблокировать: неблокирующего
линейный: линейным линейный
cpu: cpu
опенсорсный: опенсорсный
уделять: уделяют
автокомпактификация: автокомпактификацию
32битный: 32битных
64битный: 64битных
выборка: выборок
query: query
estimation: estimation
acc: acc
неизвестный: неизвестные неизвестной неизвестным
заполучить: заполучили заполучить
гвинт: гвинта
завладеть: завладеть
бухгалтерия: бухгалтерии
административный: административного административными
журналист: журналиста журналисты журналистам
сделка: сделка сделку сделки
навстречу: навстречу
намерить: намерены
минимизировать: минимизировать
заявление: заявления заявлении заявление заявлений
правоохранительный: правоохранительных правоохранительные правоохранительным
органыраный: органыранее
сохранение: сохранения сохранение
мода: моды
небезопасно: небезопасно
dll: dll
переполнение: переполнения
буфер: буфера
ps4: ps4
2077ый: 2077о
провалиться: провалился
package: package
wizard: wizard
незаменимый: незаменимый
помощник: помощник
вебприложение: вебприложений
плагин: плагин
бандло: бандл
фреймворк: фреймворк
надоедать: надоедает
копипастить: копипастить
composerпакет: composerпакет
структура: структуру структуры структур
вебприложенийответить: вебприложенийответив
сгенерировать: сгенерированные сгенерирует сгенерированных сгенерировать
базовый: базовых базовая базовую базовой базовые
классытеперить: классытеперь
приятнеечтоба: приятнеечтобы
окружение: окружение
composer: composer
global: global
require: require
andreyhelldar/packagewizardвсё: andreyhelldar/packagewizardвсё
готовопереходить: готовопереходите
пустой: пустую
папка: папку
packageinitпомощник: packageinitпомощник
файлыпроект: файлыпроект
постоянно: постоянно
пополняться: пополняется
плюшка: плюшками
превратить: превратить
рутинный: рутинный
труд: труд
времяпрепровождениепроект: времяпрепровождениепроект
опенсурсный: опенсурсным
backend: backend
научить: научили
генерировать: генерирует генерировать
фальшивый: фальшивый
днк: днк
эстония: эстония эстонии
геном: геномов геномам геномы
настоящихкак: настоящихкак
научиться: научились
практически: практически
принцип: принцип принципу
эстонский: эстонские
генетический: генетическим
фрагмент: фрагменты
этический: этической этических этическим
вопросасуществовать: вопросасуществующие
геномный: геномные
бесценный: бесценным
недоступный: недоступен недоступны недоступна
изнурительный: изнурительными
соображение: соображений
барьер: барьер
называть: называет называем
преодолеть: преодолеть
бурак: бурак
ельмена: ельмен
тартуский: тартуского
университетасогласный: университетасогласно
парадигма: парадигме
обмениваться: обмениваться
часто: часто
синтетический: синтетические
проблемкоманда: проблемкоманда
удивительно: удивительно
случайно: случайно
биобанк: биобанка
какомулибо: какомулибо
донор: донору
исследованияученый: исследованияученые
близость: близость
сохраняться: сохраняется сохраняться
недостаточно: недостаточно
популяция: популяций
clubhouse: clubhouse
вечером: вечером
сервисаclubhouse: сервисаclubhouse
возврат: возврата возврат
маловероятный: маловероятен
интернетатакий: интернетатакое
блокировкива: блокировкив
критиковаться: критикуется
модерация: модерация модерации
уничижительный: уничижительных
отношенийприложение: отношенийприложение
vpn: vpn
бенджамин: бенджамин
исмаил: исмаил
greatfire: greatfire
цензура: цензуры цензурой цензуру
выгодно: выгодно
дальнейший: дальнейшем дальнейшую
властейточный: властейточное
неизвестно: неизвестно
комната: комнате
демократический: демократическом
протест: протестов протесте
1989: 1989
тяньаньмэнь: тяньаньмэнь
собраться: собрались
вместимость: вместимости
чатапосле: чатапосле
проверочный: проверочные
techcrunch: techcrunch
многие: многие
телефонный: телефонных телефонной телефонными
облегчать: облегчает
пользователейпопулярность: пользователейпопулярность
возрасти: возросла
материковый: материковом
аудитория: аудиторию аудиторией аудитория аудитории
работник: работников
инвестиционный: инвестиционной инвестиционная
академический: академических академической
образованиемза: образованиемза
times: times
заголовок: заголовком
рай: рай
материк: материка
выделить: выделенными выделят выделены
антигосударственный: антигосударственными
цитатамисоциальный: цитатамисоциальная
долина: долине
24: 24
перемещаться: перемещаются
комнатамичат: комнатамичатами
аудио: аудио
приглашение: приглашение
интриговать: интригует
цветок: цветка
wikimedia: wikimedia
commons: commons
аномальный: аномального
провайдер: провайдеров
поступать: поступает поступало поступающую поступают
одинаковый: одинаковых одинаковой
url: url
https//uploadwikimediaorg/wikipedia/commons/thumb/1/16/asternovibelgiiflower1mbjpg/1280pxasternovibelgiiflower1mbjpg: https//uploadwikimediaorg/wikipedia/commons/thumb/1/16/asternovibelgiiflower1mbjpg/1280pxasternovibelgiiflower1mbjpg
referer: referer
useragent: useragent
странно: странно
ip: ip
нормальный: нормальная нормальному
дневный: дневному
посетитель: посетителей
какоеть: какоето
заставка: заставке
хотлинк: хотлинк
картинка: картинку
википедия: википедии
img: <img
src=: src="https//uploadwikimediaorg/wikipedia/commons/thumb/1/16/asternovibelgiiflower1mbjpg/1280pxasternovibelgiiflower1mbjpg">
провиниться: провинилось
продолжаться: продолжается
централизовать: централизованное
звукозапись: звукозаписей
видеоролик: видеоролик видеороликов
мультимедийный: мультимедийных
страница: страницам страниц страница страницы странице страницах
викимедиа: викимедиа
свободно: свободно
изменять: изменять изменяя
gpt3: gpt3
разбирать: разбирает
входящий: входящих входящую
университетский: университетского
колледж: колледжа
маастрихт: маастрихта
посвятить: посвящен посвященную посвящено
почтовый: почтового почтовых
исследуться: исследуется
проигрывать: проигрывает
сектор: секторах
энергетика: энергетики
точный: точные точный
массив: массивам массивом массива
неструктурированный: неструктурированных
экономически: экономически
нулевой: нулевыми нулевые нулевого
потратиться: потратиться
заблуждение: заблуждение
оскорбительный: оскорбительный
судебный: судебную судебным
рано: рано
чатбот: чатбот
выглядеть: выглядит выглядят
альтернативойopenai: альтернативойopenai
обученный: обученную
175: 175
июнь: июнь июне июня
gpt2: gpt2
gpt1: gpt1
применить: применить
пациент: пациентами
неутешительнымимежда: неутешительнымимежду
gptneo: gptneo
eleutherai: eleutherai
аналог: аналог
обучить: обучили
steam: steam
valve: valve
игровой: игровая игровой игровых
51: 51
counterstrike: counterstrike
offensive: offensive
dota: dota
одобрить: одобренные одобрила одобрены
шанхайский: шанхайской
perfect: perfect
world: world
повлиять: повлияют повлияет
альфаверсия: альфаверсия
понимать: понимает
шаткость: шаткость
государство: государства государств государство государствами
локализовать: локализовать
сотрудничать: сотрудничать
старт: старте
приставка: приставок
verge: verge
инсайдер: инсайдера
даниэль: даниэля
ахмад: ахмада
сопрячь: сопряжён
terraria: terraria
stadia: stadia
бан: бана баны
youtubeаккаунт: youtubeаккаунт
эндрю: эндрю
спинкса: спинкса
пользование: пользования
забанить: забанили
безуспешный: безуспешных
разбирательство: разбирательства разбирательств
relogic: relogic
порт: порт
stadiaэндрю: stadiaэндрю
спинкс: спинксу спинкс
конфликт: конфликте
корпорация: корпорацией
удар: удар
нарушить: нарушил нарушит
play: play
сожаление: сожаления
успеть: успел
досмотреть: досмотреть
купить: купленную купить купила
кинотрилогия: кинотрилогию
властелин: властелин
gmail: gmail
летпосле: летпосле
предпринять: предпринятых
попытка: попыток попытки попытка
разрешить: разрешить разрешенных
сложиться: сложившееся
недоразумение: недоразумение
назвать: назвал назвать
мост: мостов
googleплатформ: googleплатформы
связываться: связываться
ценить: ценит
партнёровва: партнёровв
twitterаккаунт: twitterаккаунте
снять: снять
запрет: запрет
публиковаться: публиковались
googleаккаунт: googleаккаунт
заблокированrelogic: заблокированrelogic
техподдержка: техподдержкой техподдержке
затруднительный: затруднительным
переписка: переписка
почтуyoutube: почтуyoutube
отклонить: отклонил
нерелевантный: нерелевантные
миллионный: миллионной
спрашивать: спрашивала
забанный: забанен
забытый: забытого
добровольно: добровольно
удалять: удалять
утверждение: утверждения утверждений
вакцина: вакцинах вакцины
аутизм: аутизм
удаляться: удаляться
касательно: касательно
прививка: прививки прививку
токсичный: токсичны
аутизмобновлить: аутизмобновлённая
неэффективный: неэффективны
переболеть: переболеть
заболеваниякомпания: заболеваниякомпания
сосредоточить: сосредоточено сосредоточит
уличить: уличены
распространитель: распространителей
особо: особо
рьяный: рьяных
блокировать: блокирует блокировать
рецидив: рецидива
чрезвычайный: чрезвычайная
здравоохранение: здравоохранения
нанести: нанесёт
сокрушительный: сокрушительный
антипрививочный: антипрививочному
недолго: недолго
ужесточение: ужесточение
оказать: окажет оказать
влияние: влияния влияние
последователь: последователями
конспирологический: конспирологических
теория: теорий
фейковый: фейковые
подлежать: подлежат
опровергнуть: опровергли опровергнуты
критерий: критерии
попытаться: попытались
отравить: отравить
житель: жителей
понедельник: понедельник
водопроводный: водопроводную
ph: ph
свинец: свинца
металл: металлов
жидкость: жидкости
ожогиочистный: ожогиочистная
обслуживать: обслуживает
тамп: тампы
авария: аварии авария аварий
неисправность: неисправностей
reuters: reuters
департамент: департамента департаменте департамент
информациювпервые: информациювпервые
придать: придал придаст
регулярно: регулярно
подключаться: подключался подключается
через: через
1330: 1330
вновь: вновь
сей: сей сих
автоматика: автоматики
11100: 11100
ppm: ppm
покинуть: покинул
отреагировать: отреагировали
противный: противном
переизбыток: переизбыток
щёлок: щёлока
дойти: дошла
стократный: стократное
отравление: отравления
обеспокоить: обеспокоила обеспокоить
чиновник: чиновники чиновников
сенатор: сенатор
марк: марк
рубио: рубио
муниципалитет: муниципалитеты
указание: указания указание
сооруженийгуалтьери: сооруженийгуалтьери
никто: никто
арестовать: арестован
следователь: следователей
мессенджер: мессенджер мессенджеру мессенджера
2013: 2013
ежегодно: ежегодно
подтверждаться: подтверждаются
аналитический: аналитические аналитическому аналитической аналитическая аналитических
sensortower: sensortower
скачивать: скачиваемым
занять: занявший занял
четвёртый: четвёртую
строчка: строчку
38: 38
секрет: секрет
постоянство: постоянство
неизменно: неизменно
улучшать: улучшали улучшать
ключ: ключей ключом
достижение: достижениям
резко: резко
whatsapp: whatsapp
дочка: дочек
критика: критику
конкурент: конкурентов конкурентам
догнать: догнал
мтс: мтс
60: 60
hyundai: hyundai
kia: kia
электрокар: электрокара
motor: motor
дочерний: дочерняя
motors: motors
corp: corp
inc: inc
приостановить: приостановила приостановленных
южнокорейский: южнокорейские
автопроизводитель: автопроизводители автопроизводитель автопроизводителя
вели: вели
электромобиль: электромобилях электромобилей
акция: акциям акций акции
62: 62%
стратегия: стратегию
ioniq: ioniq
сказать: сказано сказал сказать скажу
ли: ли
джэ: джэ
ир: ир
eugene: eugene
investment: investment
securities: securities
сеул: сеуле
23: 23
аккумуляторный: аккумуляторной
2027: 2027
принадлежащий: принадлежащих
поздний: позднее
договориться: договорились
подписать: подписали подписано подписать
партнёрство: партнерство партнерстве
baidu: baidu
geely: geely
вождение: вождения
volvo: volvo
daimler: daimler
mercedesbenz: mercedesbenz
уход: уход
безоса: безоса
телеграм: телеграме
рассказывать: рассказываю рассказывает
расшифровказатухать: расшифровказатухает
скандал: скандал
gamestop: gamestop
выше: выше
sec: sec
всетаки: всетаки
виноватый: виновата виноват
случайность: случайность
годыrobinhood: годыrobinhood
срочный: срочном
бум: бума
резервирование: резервирование
срочно: срочно
понадобиться: понадобились
пойти: пошла пошел
дисконт: дисконт
ipo: ipo
то: то
robinhood: robinhood
вложиться: вложились
переговорный: переговорной
позиция: позициях позиций позиции
85: 85
демонстративно: демонстративно
разводить: развожу
рукамить: рукамив
подписчик: подписчиков подписчикам подписчики
казаньоргсинтез: казаньоргсинтез
слышать: слышали слышал
мосбиржа: мосбирже
шорты: шортов
недооценить: недооценены
моментально: моментально
кончиться: кончились
стоп: стоп
покупать: покупает покупать
остановитесьчтый: остановитесьчто
забавно: забавно
gamestopвесить: gamestopвесь
двигаться: двигается
унисон: унисон
чтонибыть: чтонибудь
материться: матерился материться матерится
ответственный: ответственными ответственного
матерный: матерное
быстренько: быстренько
мат: мате мат
притянуть: притянуть
изменилосьзакон: изменилосьзакон
видеть: видит видите
медиалогия: медиалогия
посчитать: посчитала
немножко: немножко
выкатить: выкатили
какиеть: какието
фильтрация: фильтрации
реализовываться: реализовываться
почемуть: почемуто
висеть: висеть
посмотримукраина: посмотримукраина
оппозиционный: оппозиционных
пророссийский: пророссийская
касаться: касается
украина: украина украины украину
попросить: попросила попросил
потому: потому
прецедент: прецедентов прецедент
цензор: цензорам цензоры цензора
копирка: копирку
соглашаться: соглашаются соглашается
счастливый: счастливы
неплохо: неплохо
двойной: двойные двойным
счастие: счастью
проверять: проверял
силовик: силовиков
както: както
нагадить: нагадить
parler: parler
банилизабавный: банилизабавно
немой: нем
ceo: ceo
плохой: плохая хуже
б: б
рулить: рулили
мешать: мешали
насилие: насилию насилие
замечательный: замечательно
палец: пальцах пальцем
хостить: хостить
хоститьяндекстакси: хоститьяндекстакси
179: 179
везти: везёт
агрегатор: агрегатор
такси: такси
rutaxi: rutaxi
лайм: лайм
сатурн: сатурн
taxi: taxi
упомянуть: упомянуть упомянул
когдато: когдато
№: №
яндекстакси: яндекстакси
ситимобила: ситимобил
уменьшаться: уменьшается
уложиться: уложилась уложились
давайтек: давайтека
наверно: наверно
обходить: обходить
уменьшиться: уменьшилась
сколько: сколько
непонятно: непонятно
поразный: поразному
чисто: чисто
лоб: лоб
сложно: сложно
получаться: получается
подешеветь: подешевел
сбер: сбер сбера
помесячно: помесячно
владение: владения
модный: модная
яндексдрайв: яндексдрайва
похоже: похоже
фальстарт: фальстарт
видный: видны
lada: lada
vesta: vesta
14950: 14950
руб/месrange: руб/месrange
rover: rover
velar: velar
105: 105
259: 259
руб/месить: руб/меся
противник: противник
ограбление: ограбление
одобрять: одобряю
прям: прям
ценыamazon: ценыamazon
бессменный: бессменный
джефф: джефф
безос: безос
переставать: перестает
председатель: председателем
преемник: преемник
энди: энди
джесси: джесси
servicesпонятный: servicesпонятно
никуда: никуда
любопытно: любопытно
медленный: медленный
маркетплейс: маркетплейс маркетплейса
крайний: крайней
ковидный: ковидный
главное: главное главного
гендиректор: гендиректор гендиректором
itшный: itшный
властный: властном
завоевать: завоевал
курьер: курьеров
руководить: руководить
хостингалюбопытный: хостингалюбопытно
тигран: тигран
худавердяный: худавердян
наоборот: наоборот
офлайновый: оффлайновый оффлайновое
онлайновый: онлайновый
хостинг: хостинг
любопытнон: любопытнону
карьер: карьер
большенесколько: большенесколько
арена: арене
appannie: appannie
еда: еду еды
3м: 3м
playrix: playrix
род: родом
вологда: вологды
помоему: помоему
фантастически: фантастически
2м: 2м
значимость: значимости
стартапакселератор: стартапакселераторах
alchemist: alchemist
startups: startups
дть: демо
подсчёт: подсчетам
немного: немного
лукавый: лукавые
франция: франции
засчитывать: засчитывает
говорящий: говорящих
порусски: порусски
беларусь: беларусь беларуси
уметь: умеют
крутый: крутейшие
акселератор: акселераторы
умение: умение
красивый: красивые
молодец: молодцы
победимследовать: победимследующие
столь: столь
оптимистичный: оптимистичными
подписываться: подписывайтесь
нажимать: нажимайте
колокольчик: колокольчик
хранение: хранения
group: group
75996: 75996
строить: строим строить
оптимальный: оптимальную оптимальных
диск: дисков диске
различаться: различаются
нюанс: нюансах
хамзет: хамзет
шоген: шогенов
1700: 1700 $1700
stay: stay
tuned: tuned
вверх: вверх
подорожать: подорожал
43: $43
монета: монету
coindesk: coindesk
криптобиржа: криптобиржи криптобиржах
безумие: безумие
binance: binance
coinbase: coinbase
gemini: gemini
kraken: kraken
трудность: трудностями трудности
гибко: гибко
диверсификация: диверсификацию
золото: золото
слиток: слитках
торговать: торгуемые
доходный: доходные
приобретать: приобретать приобретает
долгосрочный: долгосрочной
вдобавок: вдобавок
первоначально: первоначально
неопределённость: неопределенности
непредсказуемость: непредсказуемостью
криптовалютный: криптовалютного
нематериальный: нематериальных
учесть: учла учесть
кибератака: кибератакам
злонамеренный: злонамеренным
биткойна: биткойн
легитимность: легитимность
скептицизм: скептицизм
cnbc: cnbc
процент: процент
эквивалент: эквивалентов
19: 19 $19
продавать: продавала продавать
bitcoin: bitcoin
ethereum: ethereum
cash: cash
litecoin: litecoin
напрямую: напрямую
звать: зовут
интересоваться: интересуетесь
ежедневный: ежедневными
серия: серию серии серия
еженедельный: еженедельных
расшифровка: расшифровки
версииновый: версииновый
порадовать: порадовал
минорный: минорными
возможностямин: возможностямина
1430: 1430
принести: принесла
возможностиподробность: возможностиподробности
material: material
дизайн: дизайна
отметиться: отметился
чемтый: чемто
значимый: значимую значим значимых
привнести: привнёс
виджетавиджет: виджетавиджет
выбор: выбора
временибесконечный: временибесконечный
прогрессвсе: прогрессвсе
into: into
sunset: sunset
on: on
may: may
1st: 1st
bintray: bintray
jcenter: jcenter
gocenter: gocenter
chartcenter: chartcenter
переезд: переезд
maven: maven
central: central
неимоверный: неимоверное
посыпиться: посыпиться
из: изо
порекомендовать: порекомендую
отключение: отключении отключение
2021dexguard: 2021dexguard
песочница: песочница
keep: keep
beta: beta
jar: jar
apk: apk
удобный: удобен
повторно: повторно
проверитьстатие: проверитьстатья
coroutine: coroutine
jvm: jvm
доносить: доносит
coroutines: coroutines
java: java
поток: поток потоках
этовидео: этовидео
приводиться: приводится
пример: примера пример примерах
краткий: краткое кратким
изменениярассказ: изменениярассказ
hilt: hilt
мигрировать: мигрировать
плейлист: плейлисте
удобно: удобно
переваривать: переваривать
мелкий: мелкими
порциямиразбор: порциямиразбор
dagger: dagger
koin: koin
капот: капотом
сравниваться: сравнивается
варить: варить
очевидный: очевидной очевидно
наиболее: наиболее
разработчиковподробность: разработчиковподробности
harmony: harmony
os: os
виртуализация: виртуализации
распределённый: распределённых
конвергенция: конвергенцию
супервиртуальный: супервиртуальному
устройствувот: устройствувот
формулировка: формулировкой
форк: форком
суть: сути
отличаться: отличается
emuihonor: emuihonor
изпод: изпод
крыло: крыла
v40: v40
флагман: флагман
сердце: сердце
kirin: kirin
раньшеести: раньшеесли
нравиться: нравится
лайкать: лайкайте
metalenz: metalenz
плоский: плоских плоской
сенсор: сенсор сенсора
мегапиксель: мегапикселей
объектив: объективы объектив объектива
внедрять: внедрять
метаповерхность: метаповерхностями
установленный: установленных
семь: семь
резкость: резкостью резкость
чёткость: четкость
оптика: оптики оптика
четырехсеметь: четырехсеми
оливер: оливер
шиндельбек: шиндельбек
zeiss: zeiss
физика: физики
аберрация: аберрацию
дисперсия: дисперсию
стремление: стремление
усовершенствовать: усовершенствовать
выпуклый: выпуклыми
1x1: 1x1
3x3: 3x3
мм: мм
наноструктура: наноструктуры
тысячная: тысячную
ширина: ширины
преломлять: преломляют
луч: луч лучи
над: над
соучредитель: соучредитель
роберт: роберт
девлина: девлин
физик: физик
федерико: федерико
капассо: капассо
микроскопический: микроскопическом
диаметр: диаметр диаметра
формировать: формировать
выходной: выходная выходное
многолинзовый: многолинзовой
передавать: передавать
чёткий: четкие
серийный: серийного серийное
стартовать: стартует
3dсенсор: 3dсенсоры
неназванный: неназванного
производителядевлина: производителядевлин
3dдатчик: 3dдатчики
truedepth: truedepth
id: id
лазер: лазеры
сканирование: сканирования
сажать: сажает
экономить: экономить
автомобильный: автомобильных
датчикахв: датчикахв
юта: юты
толщина: толщиной
микрон: микрон
лёгкий: легче
микроструктура: микроструктур
изогнутый: изогнуты
перенаправлять: перенаправляет
clickhouse: clickhouse
предиктивной: предиктивной
прана: прана
предиктивный: предиктивную
весьма: весьма
избежать: избежать
длительный: длительных
поломка: поломки
отклоняться: отклоняется
отклонение: отклонения отклонение
тп: тп
анализироваться: анализируются
математический: математическим
отслеживаться: отслеживаются
неочевидный: неочевидные
взаимосвязь: взаимосвязи
выдаваться: выдается
прогноз: прогноза прогноз
подаваться: подается
недопущение: недопущению
проблемный: проблемная проблемных проблемный
обслуживаться: обслуживается
строй: строя
дорогостоящий: дорогостоящая дорогостоящий
развиваться: развиваются
русгидро: русгидро
прогнозировать: прогнозирует
газотурбинный: газотурбинных
general: general
electric: electric
lm: lm
6000: 6000
pf: pf
df: df
турбогенератор: турбогенераторов
brush: brush
котловутилизатор: котловутилизаторов
кув381185: кув381185
оперативно: оперативно
тб: тб
колоночный: колоночная
структурировать: структурированных
фактор: факторам
спроектировать: спроектировано спроектированы
аварийный: аварийном
крайне: крайне
данный: данном данный
неполадка: неполадки
объединять: объединяет
метод: методы метод методе методов
статистический: статистического
отказоустойчивость: отказоустойчивость
программногоаппаратный: программногоаппаратному
железный: железной
прогностика: прогностики
прекрасно: прекрасно
пригодность: пригодность
масштабируемость: масштабируемости
трудоношин: трудоношин
co₂: co₂
траектория: траекторию
нагрев: нагрева нагрев
°c: °c
2050: 2050
тонна: тонн тонну
эмиссия: эмиссии
06022018: 06022018
богатый: богатый богатых
призовой: призовой
отобрать: отобраны
стипендия: стипендий
студенческий: студенческим
масштабироваться: масштабироваться масштабируется
гигатонна: гигатонн
техзадание: техзадании техзадание
соревнование: соревновании соревнование
измеримый: измеримое
воздействие: воздействие
гигатонный: гигатонного
маска: маска
масштабный: масштабном
высаживание: высаживания
оттаивание: оттаивания
вечный: вечной
мерзлота: мерзлоты
необратимый: необратимый
самоподдерживающийся: самоподдерживающийся
японский: японская японской
renesas: renesas
британский: британской британская
dialog: dialog
semi: semi
corporation: corporation
объявление: объявления
подготовка: подготовке подготовки
6750: 6750
евро: евро
штука: штуку
немецкий: немецкой
xetra: xetra
6826: $6826
5670: 5670
премия: премию
bluetooth: bluetooth
позиционировать: позиционировать
эдинбург: эдинбурге
научноисследовательский: научноисследовательской научноисследовательский
германия: германии
полдюжины: полдюжины
soc: soc
arm: arm
69: $69
насчитывать: насчитывает
155: $155
1850: 1850
ltd: ltd
орган: органам органов
лицензиат: лицензиатами
amd: amd
89: 89
chrome: chrome
x86: x86
sse3: sse3
mspoweruser: mspoweruser
chromium: chromium
20042005: 20042005
k8: k8
athlon: athlon
fx: fx
opteron: opteron
sempron: sempron
степпинг: степпингами
e3: e3
e4: e4
sse2: sse2
chromeos: chromeos
эрик: эрик
лоуренс: лоуренс
линус: линус
торвальдс: торвальдс
itanium: itanium
потерянный: потерянными
ia64: ia64
цниимаш: цниимаш
запатентовать: запатентовал запатентованной
сетка: сетка сетки
манипулятор: манипулятор манипулятора
возвращать: возвращать возвращаемая возвращаемой возвращали
ступень: ступени ступень ступенью
mr: mr
steven: steven
патент: патент патенте
тасс: тасс
собственность: собственности
описание: описание
сетчатый: сетчатой
жаропрочный: жаропрочной
механический: механический механического
20162025: 20162025
конкурентоспособность: конкурентоспособности
многоразовый: многоразовых многоразовой
выведение: выведения
авангард/флагман: авангард/флагман
конструкторский: конструкторских
бюро: бюро
ракетный: ракетного ракетному ракетный
ракетуноситель: ракетуноситель
спасение: спасения
ракетодинамический: ракетодинамической
парашютнореактивный: парашютнореактивной
крылатый: крылатой
опускаться: опускается
скользить: скользя
хвостовой: хвостовым
отсек: отсеком
фиксироваться: фиксируется
крепёжный: крепёжных
крюков: крюков
снизу: снизу
исполнительный: исполнительных
сверху: сверху
хруничев: хруничева
буран: буран
ракетнокосмический: ракетнокосмический
прогресс: прогресс
эскизный: эскизного
амур: амур
ангара: ангара
doom: doom
плис: плис
ice40: ice40
сильван: сильван
манута: манут
программировать: программируемой
интегральный: интегральной
мгц: мгц
модифицировать: модифицировать
такт: такты такте
памятьсильван: памятьсильван
объяснение: объяснениями
youtubeклассический: youtubeклассический
386dx: 386dx
мегабайт: мегабайт мегабайта
плавный: плавной
486: 486
dx2: dx2
66: 66
icebreaker: icebreaker
v10b: v10b
riscv: riscv
процессорнедостаток: процессорнедостаток
энтузиаст: энтузиаст
компенсировать: компенсировал
8мегабайтный: 8мегабайтного
spiустройство: spiустройства
поверх: поверх
флешнакопителямануть: флешнакопителяманут
геймплей: геймплеем
клавиша: клавиш
последовательный: последовательному последовательных
видеоинтерфейс: видеоинтерфейс
pmod: pmod
разъём: разъёмы разъёмом
hdmi: hdmi
githubicebreaker: githubicebreaker
ice40up5k: ice40up5k
lattice: lattice
схемотехника: схемотехникой
плат: платами
долларовфункциональный: долларовфункциональная
блоксхема: блоксхема
v10bич: v10bна
преобразователь: преобразователь
usbuart: usbuart
ft2232: ft2232
ftdi: ftdi
флэшпамять: флэшпамять
128: 128
мбитый: мбит
usbпорт: usbпорт
barcode: barcode
scanner: scanner
заразить: заразило
навязчивый: навязчивую
открываться: открывалась
anon00: anon00
сканер: сканером сканер
штрихкод: штрихкодов штрихкода
декабрьский: декабрьского
вредонос: вредоносом
sdk: sdk
включаться: включается
обфускация: обфускацию обфускации
сертификат: сертификатом
компаниирекламодателяс: компаниирекламодателясам
вручнуюгода: вручнуюгод
bitdefender: bitdefender
отображать: отображать отображающее
агрессивный: агрессивную
превысить: превысило превысила
550: 550
keyclusterer: keyclusterer
кластеризация: кластеризация кластеризации
поисковый: поисковых поисковые
обзор: обзору обзор
неопределённый: неопределенный
продолжение: продолжением
релевантный: релевантных релевантной
недоработка: недоработки
домен: доменов домен домену
пригодиться: пригодится
оптимизатор: оптимизатору оптимизатор
понимание: понимания
полезно: полезно
ручной: ручной
какойлибо: какойлибо
топ100: топ100
пересканирование: пересканирования
опция: опция
xmlлимит: xmlлимитами
заново: заново
аренда: аренды аренду
xml: xml
serpriver: serpriver
xmlproxy: xmlproxy
majento: majento
пополниться: пополнился
seo: seo
программист: программист
delphi: delphi
lte: lte
ltea: ltea
r45f: r45f
глобалинформсервис: глобалинформсервис
гис: гис
4g: 4g
телекоммуникационный: телекоммуникационного
минпромторг: минпромторга
локализация: локализация
бс: бс
высылаться: высылается
радиус: радиуса
вт: вт
2х20вт: 2х20вт
программноопределять: программноопределяемой
радиосистема: радиосистемы
sdr: sdr
протокол: протоколы протокола
ipsec: ipsec
volte: volte
nbiot: nbiot
mcptt: mcptt
холдинг: холдинга
росэлектроника: росэлектроника
госкорпорация: госкорпорации
ростёха: ростех
линейка: линейку линейке
частотный: частотных
операторский: операторского
последующий: последующего последующим
особый: особым
поручение: поручениям
василий: василий
бровкий: бровко
эволюционный: эволюционного
невозможно: невозможно
бесшовный: бесшовно
отладка: отладку
подстраивание: подстраивание
4050: $4050
telecom: telecom
денис: денис
кусок: кусков
ростех: ростеха ростеху
конкурировать: конкурировать
гигант: гигантами
вроде: вроде
ростелеком: ростелекому ростелеком
2324: 2324
ггц: ггц
строиться: строиться
нато: нато
48499: 48499
странычлен: странычлены
латвия: латвия
финляндия: финляндия
петербург: петербургом
приграничный: приграничных
регламент: регламенту
радиосвязь: радиосвязи
сопредельный: сопредельными
согласовывать: согласовывать
граница: границ
прибрежный: прибрежных
опытный: опытная
полоса: полосы
кронштадт: кронштадте
распоряжение: распоряжений
военный: военные военный военных военное
альянс: альянса
чужой: чужой
возражение: возражений возражения
турция: турции
грузия: грузии
азербайджан: азербайджана
дешёвый: дешевле
развивать: развивать развивает
3438: 3438
занятый: занят
силовой: силовых
совбез: совбез
выделение: выделении
частотмежда: частотмежду
согласование: согласование
публиковать: публикуют
мотивировка: мотивировка
указываться: указывается
уладить: уладить
обмен: обмен
5gсеть: 5gсетей
вряд: вряд
предоставление: предоставление предоставлению предоставления
мегафон: мегафоне
приемлемый: приемлемых
опасаться: опасаются
точно: точно
выпадать: выпадают
дальний: дальнего
восток: востока
придерживаться: придерживаются
вымпелкомемежда: вымпелкомемежду
городахмиллионник: городахмиллионниках
152: 152
руб: руб
2030: 2030
2413: 2413
рубть: рубв
госкомиссия: госкомиссия
радиочастота: радиочастотам
67: 67
указанный: указанном
обход: обход обхода
signal: signal
иран: иране
tlsпроксить: tlsпрокси
проксисервер: проксисерверы проксисервер проксисервера
tls: tls
ducksoft: ducksoft
studentmain: studentmain
проксить: прокси
туннель: туннель
ssl/tls: ssl/tls
развернуть: развернут
раскрывать: раскрывающим
ipадрес: ipадрес
server: server
name: name
indication: indication
sni: sni
clienthello: clienthello
доменный: доменному
прокситрафик: прокситрафик
эксплойтом: эксплойтом
proofofconcept: proofofconcept
poc: poc
демонстрировать: демонстрируют демонстрирующим
разоблачать: разоблачая
соблюдать: соблюдали
раскрытие: раскрытие раскрытия
развёртывать: развертывать
переходить: переходить
моксить: мокси
марлинспайк: марлинспайк
максимум: максимум
опасение: опасениях опасения
выгрузить: выгружены
временно: временно
выдавать: выдаёт выдает
404: 404
неуместный: неуместных
грубый: грубых
временный: временный
обходный: обходной
форустоять: форустоит
принципиально: принципиально
федеративный: федеративной
сосуществование: сосуществование
mastodon: mastodon
выписка: выписку выписок
егрн: егрн
росреестр: росреестра росреестр
недвижимость: недвижимости недвижимость
интернетпоисковик: интернетпоисковика
коммерсантъфедеральный: коммерсантъфедеральная
перепродажа: перепродажа перепродажу
коммерсант: коммерсант коммерсанту коммерсанта
рублейпоисковый: рублейпоисковый
подозревать: подозревает
наказание: наказание
рублейинициатор: рублейинициатором
назначить: назначила назначено
законность: законности
практика: практику
предоставлять: предоставляют
отказаться: отказался
коммерсантазаконопроект: коммерсантазаконопроект
дума: думе
авить: авито
циан: циан
смягчающий: смягчающие
поправкидиректор: поправкидиректор
информационный: информационного информационная информационной
культура: культура
иван: иван
бегтина: бегтин
сайтовдвойник: сайтовдвойников
мнение: мнением мнению
спрос: спрос
неудовлетворительный: неудовлетворительной
росреестраиздание: росреестраиздание
опросить: опросило
enterprise: enterprise
федюкин: федюкин
оспорить: оспорено
bgp: bgp
litigation: litigation
илья: илья
кожевник: кожевников
никак: никак
регламентироваться: регламентируется
потребовать: потребовать потребовал потребует
колумнист: колумниста
llc: llc
писатель: писателя
михаил: михаила михаил
шахназаров: шахназарова
ролик: ролик
дискриминационный: дискриминационных
высказывание: высказываний высказывания
словесный: словесные
проявление: проявления
ненависть: ненависти
враждебность: враждебности
авторский: авторском
шах: шах
общественнополитический: общественнополитической
обстановка: обстановки
восстановить: восстановить
politrussia: politrussia
руслан: руслана
осташко: осташко
17012021: 17012021
грозить: грозит
ст: ст
вступить: вступившим
10012021: 10012021
30122020: 30122020
511фз: 511фз
влечь: влечет
наложение: наложение
правонарушение: правонарушения
десятый: десятой
совокупный: совокупного
президент: президент
клевета: клеветой
ограничивать: ограничивают ограничивать
дискриминация: дискриминацию
ssb: ssb
itsumma: itsumma
56280: 56280
безумный: безумных
спасать: спасаем
справиться: справиться
site: site
specific: specific
browser: browser
ярлык: ярлыки
запускаться: запускались запускается
настольный: настольной
86основный: 86основной
отказ: отказа
издержка: издержки
перебросить: перебросить
направление: направления
взгляд: взглядов взгляд
ненужный: ненужный
администрирование: администрированию
жёсткий: жестких жестком
родительский: родительского
контролярежим: контролярежим
сайдпроект: сайдпроект
закрытие: закрытии закрытию
беспрецедентный: беспрецедентные
треть: треть
pwa: pwa
progressive: progressive
apps: apps
добывать: добывать
настолько: настолько
eth: eth
втрое: втрое
оптом: оптом
дистрибьютор: дистрибьютор дистрибьюторов
aibпартнёр: aibпартнеры
согласный: согласны согласен
гарантия: гарантию
geforce: geforce
rtx: rtx
ryzen: ryzen
обратить: обратили
видно: видно
weibo: weibo
btcer: btcer
добыча: добычей
gpu: gpu
ampere: ampere
bilibili: bilibili
fish: fish
pond: pond
f2pool: f2pool
3060: 3060
кофейня: кофейне
starbucks: starbucks
намайнил: намайнила
000053: 000053
089: $089
1123: $1123
592: $592
435: $435
транзакция: транзакцию
фишинговый: фишинговую фишинговое фишинговом фишинговой фишинговых фишинговая фишинговые
азбука: азбуки азбуку азбукой
морзе: морзе
сокрытие: сокрытия
urlадрес: urlадресов urlадреса
необычный: необычную
целенаправленный: целенаправленную
кампания: кампания кампанию кампании
вложение: вложений вложения вложение вложениях вложении вложением
шлюз: шлюзов
вектор: вектора
отсылка: отсылки
фишинга: фишинга
нестандартный: нестандартной
интерпретировать: интерпретируемой
virustotal: virustotal
сэмюэль: сэмюэль
альфред: альфред
вейл: вейл
1838: 1838
телеграф: телеграфа
буква: буква буквы
кодироваться: кодируются
звук: звук
тире: тире
длинный: длинный
183: 183
сетевой: сетевые сетевой сетевым сетевая
отправлять: отправляет отправляемого отправлять
название_компании_счет_номер_февраль_02/03/2021: название_компании_счет_номер_февраль_02/03/2021
html: html
правдоподобный: правдоподобным
оригинальный: оригинальной оригинальный
excel: excel
название_компания: [название_компании]
_счет_: _счет_
_xlsxhtml: _xlsxhtml
xlsx: xlsx
внимательный: внимательными
упростить: упростить
подозрительный: подозрительных
сопоставлять: сопоставляет
отображаться: отображается
b: b
decodemorse: decodemorse
декодировать: декодированных декодирует
шестнадцатеричный: шестнадцатеричную шестнадцатеричная
декодироваться: декодируется
тег: тегов теги
вставляться: вставляются
окончательно: окончательно
htmlстраница: htmlстраницу
таблица: таблицы
истечь: истекло
предлагаться: предлагается
htmlвложение: htmlвложение
365: 365
узконаправленный: узконаправленной
активация: активацию активации
вебформа: вебформы
логотип: логотип логотипами
убедить: убедить
заставить: заставить
одиннадцать: одиннадцать
sgs: sgs
dimensional: dimensional
metrohm: metrohm
sbi: sbi
mauritius: mauritius
nuovo: nuovo
imaie: imaie
bridgestone: bridgestone
cargeas: cargeas
oddo: oddo
bhf: bhf
asset: asset
management: management
dea: dea
capital: capital
equinti: equinti
four: four
напомнить: напомнили напомнить
​​фишинговый: ​​фишинговые
изощрённый: изощренными
обращать: обращать
пристальный: пристальное
подозрительно: подозрительно
ибслужба: ибслужбе
администратор: администраторам администратора
презентация: презентацию презентации
превосходство: превосходство
tiger: tiger
lake: lake
air: air
core: core
i71185g7: i71185g7
i71165g7: i71165g7
tdp: tdp
28: 28 $28
интернетсёрфинг: интернетсёрфинг
офисный: офисного офисной
перекодирование: перекодирование
рендеринг: рендеринг
premiere: premiere
lightroom: lightroom
topaz: topaz
labs: labs
вдвое: вдвое
webxprt: webxprt
principled: principled
отношенияоднако: отношенияоднако
противостоять: противостоять
iris: iris
xe: xe
lab: lab
немногий: немногих
intelный: intelно
автономность: автономности
сравнивать: сравнивала
acer: acer
swift: swift
47: 47
яркость: яркости
равный: равные
сертификация: сертификации
evo: evo
отзывчивость: отзывчивости
необязательно: необязательно
pcworld: pcworld
оснащаться: оснащаться
сенсорный: сенсорным
ассортимент: ассортимент
формфактор: формфакторы
параллельно: параллельно
совместимость: совместимости
решаться: решаются
производительный: производительнее
схожий: схожи
разнообразный: разнообразные
акустик: акустике
шум: шума
вентиляторапрезентация: вентиляторапрезентацию
микропроцессор: микропроцессор
потребительский: потребительского потребительском
5нанометровый: 5нанометровому
выпускать: выпускают
семейство: семейство семейства
10нм: 10нм
бенчмарка: бенчмарки
geekbench: geekbench
8ядерный: 8ядерный
i99980hk: i99980hk
proть: proв
бывший: бывший бывших
чжэн: чжэн
hp: hp
задуматься: задумалась
сооснователь: сооснователи
itстартап: itстартапов
dmarket: dmarket
внутриигровой: внутриигровыми внутриигровых
предмет: предметами
262: $262
влад: влад
панченко: панченко
тамара: тамара
слановый: сланова
кохановский: кохановский
шведский: шведская
embracer: embracer
белорусский: белорусских белорусского
головоломка: головоломок
easybrain: easybrain
640: $640
рекордный: рекордное рекордной рекордная
восемь: восемь
itпредприниматель: itпредприниматели
казахстан: казахстана
кыргызстан: кыргызстана
шардин: шардин
leta: leta
отсортировать: отсортирован
убывание: убыванию
эркин: эркин
адыл: адылов
гласман: гласман
кирилл: кирилл
трембовский: трембовский
coo: coo
зеловый: зелов
озеро: озеро
аспект: аспект
инсайдерский: инсайдерских
фрод: фрода
арсений: арсений
вершинин: вершинин
d: d
125: $125
кадровый: кадровыми
отпускной: отпускные
больничный: больничные
зарплата: зарплату
посещаемость: посещаемость
рекрутинговый: рекрутинговая
планирование: планирование
сирота: сирота
bigid: bigid
клиентский: клиентских
ccpa: ccpa
gdpr: gdpr
передовой: передовое
identity: identity
intelligence: intelligence
миша: миша
есипов: есипов
помогать: помогают помогает
кредит: кредитов кредиты кредитам
переводить: переводя
кредитный: кредитный кредитных
эквивалентный: эквивалентный
балл: балл
ипотека: ипотеки
ицкович: ицкович
cro: cro
34м: $34м
киберстрахование: киберстрахования
итсистема: итсистем
кибервымогательство: кибервымогательства
мошенничество: мошенничество
медиаконтент: медиаконтент
микит: микита
микадо: микадо
август: август
универсальный: универсальное
автоматизация: автоматизации
документооборот: документооборота
упрощать: упрощает
подпись: подписи
розенберг: розенберг
чувствительный: чувствительные
тачпады: тачпады
мультисенсорный: мультисенсорные
контакт: контакта контактам контактов
глеб: глеб
поляк: поляков
безопасно: безопасно
календарь: календаря
колобашкин: колобашкин
полетаев: полетаев
видеоигра: видеоигр
тайтл: тайтлах
aaa: aaa
долинский: долинский
173: $173
iaas/paas: iaas/paas
несанкционированный: несанкционированного
неправильный: неправильных
измайлов: измайлов
логистика: логистики
сухопутный: сухопутные
перевозка: перевозки
дверь: двери
гибкий: гибкими
филипп: филиппов
сафон: сафонов
образование: образование образования
практический: практического
урок: уроки
vr: vr
елена: елена
соболев: соболева
115: $115
прокторинг: прокторинга
онлайноценка: онлайноценок
сочетать: сочетает
личность: личности
богдан: богдан
сучик: сучик
лобанов: лобанов
113: $113
киберспортивный: киберспортивная
геймер: геймерам
индекс: индекс индекса
gpi: gpi
решающий: решающее
левенталь: левенталь
маркетинговый: маркетинговая маркетинговые
инвайта: инвайты
беседа: беседы
раскручивать: раскручивать
повышать: повышать
рентабельность: рентабельность
вовлечение: вовлечение
яков: яков
новиков: новиков
стискин: стискин
seed: seed
finom: finom
бизнессчёт: бизнессчёта
самозанятой: самозанятым
фрилансер: фрилансерам
бухгалтерский: бухгалтерский
бигай: бигай
онлайнрепетитор: онлайнрепетиторов
185: 185
виталий: виталий
буза: бузу
метеорологический: метеорологических
растение: растений
заслуживать: заслуживают
маша: маша
седов: седова
cpo: cpo
cентябрь: cентябрь
human: human
risk: risk
platform: platform
стас: стас
матвиенко: матвиенко
анна: анна
полищук: полищук
166: $166
ресторан: рестораны
занятой: занятыми
бронировать: бронировать
food: food
preordering: preordering
72: $72
upd: upd
мегасделка: мегасделка
спасибо: спасибо
старое: старого
блогев: блогев
legacy: legacy
прекратиться: прекратится
плановый: плановое
edgeпочти: edgeпочти
совершенно: совершенно
20h2: 20h2
1803: 1803
1809: 1809
1903: 1903
1909: 1909
2004: 2004
internet: internet
explorer: explorer
закончиться: закончится
годуклиент: годуклиенты
ie: ie
онлайнсреда: онлайнсреда
вебстандарт: вебстандарты
контекст: контексте
повседневный: повседневных
outlook: outlook
teams: teams
sharepoint: sharepoint
повреждение: повреждения повреждением повреждение
файловый: файловой
ntfs: ntfs
8501: 8501
адресный: адресной
однострочный: однострочной
вставить: вставила
iter: iter
begin: begin
illegal: illegal
filenames: filenames
anyway: anyway
while: while
support: support
some: some
ads: ads
stuff: stuff
none: none
them: them
syntax: syntax
findinreadableu: findinreadableu"$"_ns
true: true
атрибут: атрибутом
i30: i30 $i30
джонас: джонасом
л: л
мгновенно: мгновенно
xp: xp
отработка: отработки
перезагрузить: перезагрузить
повредить: поврежденные
индексация: индексацию
повреждаться: повреждается
mft: mft
загружаться: загружаться
устранение: устранением
активировать: активировать
osr: osr
неофициальный: неофициальный
заплатка: заплатка
great: great
suspender: suspender
каталог: каталога
извещение: извещение
порасширение: порасширение
останавливать: останавливало
неактивный: неактивных
перезагружать: перезагружало
возвращаться: возвращался
подобно: подобно
sleeping: sleeping
tabs: tabs
ветвь: ветви
обвинение: обвинений
techsmart: techsmart
дэвид: дэвид
фостер: фостер
обновиться: обновилось
ghacksnet: ghacksnet
tgs: tgs
719: 719
кодаобновление: кодаобновление
скомпрометировать: скомпрометированы скомпрометированный
themageking: themageking
каталогамногий: каталогамногие
внезапный: внезапное
вкладокраный: вкладокранее
откатить: откатить
716: 716
привыкнуть: привык
open: open
source: source
vulnerabilities: vulnerabilities
osv: osv
подверженный: подвержены
фаззинга: фаззинга
ossfuzz: ossfuzz
бывать: бывает
трудно: трудно
сопоставить: сопоставить
​​как: ​​как
common: common
exposures: exposures
cve: cve
enumeration: enumeration
cpe: cpe
фактический: фактическим
сопровождение: сопровождению
уязвимый: уязвимых
нехватка: нехватку
перегрузить: перегружены
сопровождать: сопровождающим сопровождающего
запрашивать: запрашивать
отчётность: отчетности
коммит: коммиты коммитов
воспроизведение: воспроизведения
хеш: хешем
входной: входных
380: 380
oss: oss
наладить: наладить
языковой: языковых
купон: купон купона купону
macrumors: macrumors
недовольный: недовольные
отзыв: отзывы
transition: transition
kit: kit
dtk: dtk
действительный: действителен
mac: mac
уведомить: уведомила
прерываться: прерывался
universal: universal
quick: quick
start: start
program: program
mini: mini
a12z: a12z
оз: озу
512: 512
невозвращение: невозвращения
чинить: чинить
комплектация: комплектацию
коробка: коробке
неповреждённый: неповрежденном
устраивать: устраивает
буянить: буянить
протестный: протестных
независимо: независимо
политический: политических
правопорядок: правопорядка
митинг: митинга
федерация: федерации
неудалённый: неудаленных
спровоцировать: спровоцировать
недавний: недавняя недавнего
пропатчить: пропатчена
ибэксперт: ибэксперт
уилла: уилл
дорманна: дорманн
x86_64: x86_64
aarch64: aarch64
спутник: спутники спутника спутников спутник
geo: geo
вячеслав: вячеслав
ермолин: ермолин
гтекущий: гтекущая
февралямиссиякитайский: февралямиссиякитайский
геостационарный: геостационарных геостационарные геостационарный геостационарную
tjsw: tjsw
недоступныинфографик: недоступныинфографика
cz3b/tjswич: cz3b/tjswна
качестведевизкитай: качестведевизкитай
космософициальный: космософициального
девиз: девиза
нетвремя: нетвремя
старта04: старта04
1536: 1536
utcкосмодром: utcкосмодром
сичан: сичан
провинция: провинция
сычуаня: сычуань
китайракетаносительcz3b/g3: китайракетаносительcz3b/g3
chang: chang
zheng3b/g3: zheng3b/g3
№y77: №y77
трехступенчатый: трехступенчатая
ракетаноситель: ракетаноситель ракетаносителей
навесный: навесными
ускоритель: ускорителями
водородный: водородная
орбитуполезный: орбитуполезная
нагрузкаtjsw6: нагрузкаtjsw6
tjsw1: tjsw1
демонстрация: демонстрации
коммуникационный: коммуникационных
ka: ka
широкополосный: широкополосных широкополосной
радиотехнический: радиотехническая
предупрежденияорбитаконечный: предупрежденияорбитаконечная
геостационарнаягеопереходный: геостационарнаягеопереходная
631: 631
х: х
35811: 35811
2847°интересный: 2847°интересное
360ть: 360й
zheng: zheng
11й: 11й
4й: 4й
6й: 6й
73й: 73й
cz3b: cz3b
21й: 21й
cz3b/g3: cz3b/g3
без: без
кг: кг
leo: leo
000: 000
качествес: качествес
nsfэмблема: nsfэмблемы
нашивка: нашивки
миссиилегенд: миссиилегенда
статистикеличный: статистикеличное
мнениеспекуляция: мнениеспекуляции
перехват: перехвата
боевой: боевого
оружие: оружием
договор: договоров
тащить: тащат
хотеться: хочется
верить: верить
любитель: любитель
космонавтика: космонавтики
росси‪ь: росси‪и
коммерсантъ: коммерсантъ
защитный: защитной
оговорить: оговорено
сверка: сверки
зеркалируть: зеркалирующего
неактуальный: неактуальных
техзаданииэксперт: техзаданииэксперт
ростелекомсолар: ростелекомсолар
избыточный: избыточна
смс: смс
серчинформ: серчинформ
алексей: алексей
дрозд: дрозд
логировать: логировать
исходящий: исходящих
тз: тз
заказчик: заказчик
вечер: вечер
88: 88
развёртываться: развертывается
8804324150: 8804324150
эксплуатировать: эксплуатируемой
маттиас: маттиас
буэленс: буэленс
webassembly: webassembly
v8: v8
жертва: жертвы
вдаваться: вдаваться
cve202121148: cve202121148
сведение: сведениям
проекты​​: проекты​​
zdnet: zdnet
северокорейский: северокорейских
полагаться: полагались
explorerверсия: explorerверсия
анализатор: анализатор
flash: flash
ftp: ftp
…: …
бетапрограмма: бетапрограммы бетапрограмма
допустимый: допустимый
etc: etc
статус: статус
алабама: алабаме
коннектикут: коннектикуте
ньюгэмпшир: ньюгэмпшире
ньюйорк: ньюйорке
теннесси: теннесси
сельский: сельских
900: $900
субсидия: субсидий
rural: rural
digital: digital
opportunity: opportunity
fund: fund
rdof: rdof
943: 943
вывести: вывести
4425: 4425
143spacex: 143spacex
пропускной: пропускную
100/20: 100/20
мегабит: мегабит
подавлять: подавляющее
31: 31
бетатестер: бетатестеров
700: 700
увлечение: увлечение
мозг: мозгов
дания: дании
иив: иив
хуан: хуан
матеосгарсия: матеосгарсия
константинос: константинос
статулопулос: статулопулос
благотворительный: благотворительной
nesta: nesta
юровецкий: юровецким
дэниел: дэниелом
хейном: хейном
бизнесшкола: бизнесшколы
ольборг: ольборг
786: 786
2000: 2000
карьерный: карьерные
сдвиг: сдвиги
миграциить: миграциив
отток: оттоке
талант: талантов
заключать: заключают
исследователяпричина: исследователяпричина
беспокоить: беспокоить
приоритетный: приоритетное
обучениять: обученияв
резонанс: резонанс
увольнение: увольнение
тимнить: тимнит
гебра: гебру
соруководитель: соруководителя
этика: этике
brain: brain
отодвинуть: отодвинуть
неприемлемоавтор: неприемлемоавторы
заметный: заметен
академик: академиков
престижный: престижных
заведение: заведениях
карнегимеллон: карнегимеллона
стэнфорд: стэнфорд
принстон: принстон
институтсреди: институтсреди
привлекать: привлекает
годаво: годаво
летв: летв
затрагиваться: затрагиваются
различие: различия
цитировать: цитируют
отраслевой: отраслевые
стагнация: стагнации
работодатель: работодатели
устояться: устоявшихся
